"lang"
{
"Language"	"turkish"
"Tokens"
{
"chat_filterbutton"	"Filtreler"
"[english]chat_filterbutton"	"Filters"
"filter_joinleave"	"Katılımlar/Ayrılmalar"
"[english]filter_joinleave"	"Joins/Leaves"
"filter_namechange"	"İsim Değişiklikleri"
"[english]filter_namechange"	"Name Changes"
"filter_publicchat"	"Herkese Açık Sohbet"
"[english]filter_publicchat"	"Public Chat"
"filter_servermsg"	"Sunucu Mesajları"
"[english]filter_servermsg"	"Server Messages"
"filter_teamchange"	"Takım Değişiklikleri"
"[english]filter_teamchange"	"Team Changes"
"filter_achievement"	"Başarım Duyurusu"
"[english]filter_achievement"	"Achievement Announce"
"chat_say"	"Yaz :"
"[english]chat_say"	"Say :"
"chat_say_team"	"Yaz (TAKIM) :"
"[english]chat_say_team"	"Say (TEAM) :"
}
}
