"lang"
{
"Language"	"french"
"Tokens"
{
"chat_filterbutton"	"Filtres"
"[english]chat_filterbutton"	"Filters"
"filter_joinleave"	"Entrées/sorties"
"[english]filter_joinleave"	"Joins/Leaves"
"filter_namechange"	"Changements de nom"
"[english]filter_namechange"	"Name Changes"
"filter_publicchat"	"Chat public"
"[english]filter_publicchat"	"Public Chat"
"filter_servermsg"	"Messages du serveur"
"[english]filter_servermsg"	"Server Messages"
"filter_teamchange"	"Changements d'équipe"
"[english]filter_teamchange"	"Team Changes"
"filter_achievement"	"Annonce de succès"
"[english]filter_achievement"	"Achievement Announce"
"chat_say"	"Dire :"
"[english]chat_say"	"Say :"
"chat_say_team"	"Dire (ÉQUIPE) :"
"[english]chat_say_team"	"Say (TEAM) :"
}
}
