"lang"
{
"Language"	"polish"
"Tokens"
{
"chat_filterbutton"	"Filtry"
"[english]chat_filterbutton"	"Filters"
"filter_joinleave"	"Dołączenia/odłączenia"
"[english]filter_joinleave"	"Joins/Leaves"
"filter_namechange"	"Zmiany nazwy"
"[english]filter_namechange"	"Name Changes"
"filter_publicchat"	"Czat publiczny"
"[english]filter_publicchat"	"Public Chat"
"filter_servermsg"	"Komunikaty serwera"
"[english]filter_servermsg"	"Server Messages"
"filter_teamchange"	"Zmiany drużyny"
"[english]filter_teamchange"	"Team Changes"
"filter_achievement"	"Powiadomienia o osiągnięciach"
"[english]filter_achievement"	"Achievement Announce"
"chat_say"	"Mów:"
"[english]chat_say"	"Say :"
"chat_say_team"	"Mów (DRUŻYNA):"
"[english]chat_say_team"	"Say (TEAM) :"
}
}
