"lang"
{
"Language"	"thai"
"Tokens"
{
"chat_filterbutton"	"ตัวกรอง"
"[english]chat_filterbutton"	"Filters"
"filter_joinleave"	"เข้าร่วม/ออก"
"[english]filter_joinleave"	"Joins/Leaves"
"filter_namechange"	"เปลี่ยนชื่อ"
"[english]filter_namechange"	"Name Changes"
"filter_servermsg"	"ข้อความระบบ"
"[english]filter_servermsg"	"Server Messages"
"filter_teamchange"	"เปลี่ยนทีม"
"[english]filter_teamchange"	"Team Changes"
"chat_say"	"พูด :"
"[english]chat_say"	"Say :"
"chat_say_team"	"พูด (ทีม) :"
"[english]chat_say_team"	"Say (TEAM) :"
}
}
