"lang"
{
"Language"	"ukrainian"
"Tokens"
{
"chat_filterbutton"	"Фільтри"
"[english]chat_filterbutton"	"Filters"
"filter_joinleave"	"Долучення/вилучення"
"[english]filter_joinleave"	"Joins/Leaves"
"filter_namechange"	"Зміни псевдонімів"
"[english]filter_namechange"	"Name Changes"
"filter_publicchat"	"Загальний чат"
"[english]filter_publicchat"	"Public Chat"
"filter_servermsg"	"Повідомлення сервера"
"[english]filter_servermsg"	"Server Messages"
"filter_teamchange"	"Зміни команд"
"[english]filter_teamchange"	"Team Changes"
"chat_say"	"Написати:"
"[english]chat_say"	"Say:"
"chat_say_team"	"Написати (КОМАНДІ):"
"[english]chat_say_team"	"Say (TEAM):"
"chat_say_coach"	"Написати (УЧНЯМ):"
"[english]chat_say_coach"	"Say (TO STUDENTS):"
"chat_say_student"	"Написати (ТРЕНЕРУ):"
"[english]chat_say_student"	"Say (TO COACH):"
"chat_sourcetv"	"(Dota-ТБ) %s1"
"[english]chat_sourcetv"	"(Dota TV) %s1"
}
}
