"lang"
{
"Language"	"hungarian"
"Tokens"
{
"chat_filterbutton"	"Szűrők"
"[english]chat_filterbutton"	"Filters"
"filter_joinleave"	"Belépők/Kilépők"
"[english]filter_joinleave"	"Joins/Leaves"
"filter_namechange"	"Névváltások"
"[english]filter_namechange"	"Name Changes"
"filter_publicchat"	"Nyilvános csevegés"
"[english]filter_publicchat"	"Public Chat"
"filter_servermsg"	"Szerverüzenetek"
"[english]filter_servermsg"	"Server Messages"
"filter_teamchange"	"Csapatváltások"
"[english]filter_teamchange"	"Team Changes"
"filter_achievement"	"Teljesítmény-bejelentés"
"[english]filter_achievement"	"Achievement Announce"
"chat_say"	"Mond :"
"[english]chat_say"	"Say :"
"chat_say_team"	"Mond (CSAPAT) :"
"[english]chat_say_team"	"Say (TEAM) :"
}
}
