"lang"
{
"Language"	"italian"
"Tokens"
{
"chat_filterbutton"	"Filtri"
"[english]chat_filterbutton"	"Filters"
"filter_joinleave"	"Unioni/Abbandoni"
"[english]filter_joinleave"	"Joins/Leaves"
"filter_namechange"	"Cambi di nome"
"[english]filter_namechange"	"Name Changes"
"filter_publicchat"	"Chat pubblica"
"[english]filter_publicchat"	"Public Chat"
"filter_servermsg"	"Messaggi del server"
"[english]filter_servermsg"	"Server Messages"
"filter_teamchange"	"Cambi di squadra"
"[english]filter_teamchange"	"Team Changes"
"filter_achievement"	"Annuncio dell'achievement"
"[english]filter_achievement"	"Achievement Announce"
"chat_say"	"Parla :"
"[english]chat_say"	"Say :"
"chat_say_team"	"Parla (SQUADRA) :"
"[english]chat_say_team"	"Say (TEAM) :"
}
}
