"lang"
{
"Language"	"dutch"
"Tokens"
{
"chat_filterbutton"	"Filters"
"[english]chat_filterbutton"	"Filters"
"filter_joinleave"	"Doet mee/Gaat weg"
"[english]filter_joinleave"	"Joins/Leaves"
"filter_namechange"	"Naamswijzigingen"
"[english]filter_namechange"	"Name Changes"
"filter_publicchat"	"Openbare chat"
"[english]filter_publicchat"	"Public Chat"
"filter_servermsg"	"Serverberichten"
"[english]filter_servermsg"	"Server Messages"
"filter_teamchange"	"Teamwijzigingen"
"[english]filter_teamchange"	"Team Changes"
"filter_achievement"	"Prestatieaankondiging"
"[english]filter_achievement"	"Achievement Announce"
"chat_say"	"Zeg :"
"[english]chat_say"	"Say :"
"chat_say_team"	"Zeg (TEAM) :"
"[english]chat_say_team"	"Say (TEAM) :"
}
}
