"lang"
{
"Language"	"greek"
"Tokens"
{
"chat_filterbutton"	"Φίλτρο"
"[english]chat_filterbutton"	"Filters"
"filter_joinleave"	"Συμμετέχει/Αποχωρεί"
"[english]filter_joinleave"	"Joins/Leaves"
"filter_namechange"	"Αλλαγές ονόματος"
"[english]filter_namechange"	"Name Changes"
"filter_publicchat"	"Δημόσια συνομιλία"
"[english]filter_publicchat"	"Public Chat"
"filter_servermsg"	"Μηνύματα διακομιστή"
"[english]filter_servermsg"	"Server Messages"
"filter_teamchange"	"Αλλαγές ομάδας"
"[english]filter_teamchange"	"Team Changes"
"filter_achievement"	"Ανακοίνωση επιτεύγματος"
"[english]filter_achievement"	"Achievement Announce"
"chat_say"	"Μήνυμα:"
"[english]chat_say"	"Say :"
"chat_say_team"	"Μήνυμα (ΟΜΑΔΑ):"
"[english]chat_say_team"	"Say (TEAM) :"
}
}
