"lang"
{
"Language"	"brazilian"
"Tokens"
{
"chat_filterbutton"	"Filtros"
"[english]chat_filterbutton"	"Filters"
"filter_joinleave"	"Entradas/saídas"
"[english]filter_joinleave"	"Joins/Leaves"
"filter_namechange"	"Trocas de nome"
"[english]filter_namechange"	"Name Changes"
"filter_publicchat"	"Conversa pública"
"[english]filter_publicchat"	"Public Chat"
"filter_servermsg"	"Mensagens do servidor"
"[english]filter_servermsg"	"Server Messages"
"filter_teamchange"	"Trocas de equipe"
"[english]filter_teamchange"	"Team Changes"
"filter_achievement"	"Anúncio de conquistas"
"[english]filter_achievement"	"Achievement Announce"
"chat_say"	"Falar :"
"[english]chat_say"	"Say :"
"chat_say_team"	"Falar (EQUIPE) :"
"[english]chat_say_team"	"Say (TEAM) :"
}
}
