"lang"
{
"Language"	"korean"
"Tokens"
{
"chat_filterbutton"	"필터"
"[english]chat_filterbutton"	"Filters"
"filter_joinleave"	"입장/퇴장"
"[english]filter_joinleave"	"Joins/Leaves"
"filter_namechange"	"이름 변경"
"[english]filter_namechange"	"Name Changes"
"filter_publicchat"	"공개 채팅"
"[english]filter_publicchat"	"Public Chat"
"filter_servermsg"	"서버 메시지"
"[english]filter_servermsg"	"Server Messages"
"filter_teamchange"	"팀 변경"
"[english]filter_teamchange"	"Team Changes"
"filter_achievement"	"도전 과제 알림"
"[english]filter_achievement"	"Achievement Announce"
"chat_say"	"대화:"
"[english]chat_say"	"Say :"
"chat_say_team"	"대화 (팀) :"
"[english]chat_say_team"	"Say (TEAM) :"
}
}
