"lang"
{
"Language"	"tchinese"
"Tokens"
{
"chat_filterbutton"	"過濾器"
"[english]chat_filterbutton"	"Filters"
"filter_joinleave"	"加入/離開"
"[english]filter_joinleave"	"Joins/Leaves"
"filter_namechange"	"變更名稱"
"[english]filter_namechange"	"Name Changes"
"filter_publicchat"	"公開交談"
"[english]filter_publicchat"	"Public Chat"
"filter_servermsg"	"伺服器訊息"
"[english]filter_servermsg"	"Server Messages"
"filter_teamchange"	"變更團隊"
"[english]filter_teamchange"	"Team Changes"
"filter_achievement"	"成就公告"
"[english]filter_achievement"	"Achievement Announce"
"chat_say"	"發言："
"[english]chat_say"	"Say :"
"chat_say_team"	"發言（團隊）："
"[english]chat_say_team"	"Say (TEAM) :"
}
}
