"lang"
{
"Language"	"japanese"
"Tokens"
{
"chat_filterbutton"	"フィルタ"
"[english]chat_filterbutton"	"Filters"
"filter_joinleave"	"参加/退出"
"[english]filter_joinleave"	"Joins/Leaves"
"filter_namechange"	"名前を変更"
"[english]filter_namechange"	"Name Changes"
"filter_publicchat"	"全体チャット"
"[english]filter_publicchat"	"Public Chat"
"filter_servermsg"	"サーバーメッセージ"
"[english]filter_servermsg"	"Server Messages"
"filter_teamchange"	"チーム変更"
"[english]filter_teamchange"	"Team Changes"
"filter_achievement"	"実績のアナウンス"
"[english]filter_achievement"	"Achievement Announce"
"chat_say"	"発言 :"
"[english]chat_say"	"Say :"
"chat_say_team"	"発言 (チーム) :"
"[english]chat_say_team"	"Say (TEAM) :"
}
}
