"lang"
{
"Language"	"romanian"
"Tokens"
{
"chat_filterbutton"	"Filtre"
"[english]chat_filterbutton"	"Filters"
"filter_joinleave"	"Intrări/Ieșiri"
"[english]filter_joinleave"	"Joins/Leaves"
"filter_namechange"	"Schimbări de nume"
"[english]filter_namechange"	"Name Changes"
"filter_publicchat"	"Discuție Publică"
"[english]filter_publicchat"	"Public Chat"
"filter_servermsg"	"Mesajele Serverului"
"[english]filter_servermsg"	"Server Messages"
"filter_teamchange"	"Schimbări de echipă"
"[english]filter_teamchange"	"Team Changes"
"filter_achievement"	"Anunţ realizări"
"[english]filter_achievement"	"Achievement Announce"
"chat_say"	"Spune :"
"[english]chat_say"	"Say :"
"chat_say_team"	"Spune (ECHIPĂ) :"
"[english]chat_say_team"	"Say (TEAM) :"
}
}
