"lang"
{
"Language"	"turkish"
"Tokens"
{
"GameUI_ReverseMouse"	"Ters Fare Hareketi"
"[english]GameUI_ReverseMouse"	"Reverse mouse"
"GameUI_ReverseMouseLabel"	"Ters yukarı-aşağı fare ekseni"
"[english]GameUI_ReverseMouseLabel"	"Reverse mouse up-down axis"
"GameUI_MouseLook"	"Fare bakışı"
"[english]GameUI_MouseLook"	"Mouse look"
"GameUI_MouseLookLabel"	"Etrafa bakmak için fareyi kullan"
"[english]GameUI_MouseLookLabel"	"Use the mouse to look around"
"GameUI_MouseFilter"	"Fare filtresi"
"[english]GameUI_MouseFilter"	"Mouse filter"
"GameUI_MouseFilterLabel"	"Fare hareketini 2 kare üzerinde pürüzsüzleştir."
"[english]GameUI_MouseFilterLabel"	"Smooth out mouse movement over 2 frames."
"GameUI_MouseSensitivity"	"Fare hassasiyeti"
"[english]GameUI_MouseSensitivity"	"Mouse sensitivity"
"GameUI_Joystick"	"Oyun Kumandası"
"[english]GameUI_Joystick"	"Gamepad"
"GameUI_JoystickLabel"	"Oyun kumandasını etkinleştir"
"[english]GameUI_JoystickLabel"	"Enable the gamepad"
"GameUI_ReverseJoystick"	"Kumandanın yukarı-aşağı eksenini ters çevir"
"[english]GameUI_ReverseJoystick"	"Reverse gamepad up-down axis"
"GameUI_JoystickLook"	"Kumanda kolu bakışı"
"[english]GameUI_JoystickLook"	"Joystick look"
"GameUI_JoystickLookLabel"	"Etrafa bakmak için oyun kumandasını kullan"
"[english]GameUI_JoystickLookLabel"	"Use the gamepad to look around"
"GameUI_JoystickLookType"	"Bakış türü"
"[english]GameUI_JoystickLookType"	"Look type"
"GameUI_JoystickNormal"	"Normal"
"[english]GameUI_JoystickNormal"	"Normal"
"GameUI_JoystickInverted"	"Ters"
"[english]GameUI_JoystickInverted"	"Inverted"
"GameUI_JoystickMoveLookSticks"	"Hareket/Bakış analogları"	[$WIN32]
"[english]GameUI_JoystickMoveLookSticks"	"Move/Look sticks"
"GameUI_JoystickMoveLookSticks"	"Analoglar"	[$X360]
"[english]GameUI_JoystickMoveLookSticks"	"Thumbsticks"
"GameUI_JoystickSouthpaw"	"Kumanda analoglarının işlevlerini birbirleriyle değiştir"	[$WIN32]
"[english]GameUI_JoystickSouthpaw"	"Swap sticks on dual-stick controllers"
"GameUI_JoystickSouthpaw"	"Solak Modu"	[$X360]
"[english]GameUI_JoystickSouthpaw"	"Southpaw"
"GameUI_JoystickLookSpeedPitch"	"Dikey hassaslık"
"[english]GameUI_JoystickLookSpeedPitch"	"Vertical sensitivity"
"GameUI_JoystickLookSpeedYaw"	"Yatay hassaslık"
"[english]GameUI_JoystickLookSpeedYaw"	"Horizontal sensitivity"
"GameUI_JoystickDuckZoomMode"	"Çömelme/Yakınlaştırma modu"
"[english]GameUI_JoystickDuckZoomMode"	"Duck/Zoom mode"
"GameUI_JoystickDuckMode"	"Çömelme modu"
"[english]GameUI_JoystickDuckMode"	"Duck mode"
"GameUI_JoystickSprintMode"	"Analogla Koşma"
"[english]GameUI_JoystickSprintMode"	"Sticky Sprint"
"GameUI_AutoAim"	"Otomatik Hedefleme"
"[english]GameUI_AutoAim"	"Auto-Aim"
"GameUI_AutoaimLabel"	"Düşmanları kendiliğinden hedefler."
"[english]GameUI_AutoaimLabel"	"Aims at enemies automatically."
"GameUI_ContentLock"	"İçerik kilidi"
"[english]GameUI_ContentLock"	"Content lock"
"GameUI_ContentLockLabel"	"Küçük yaştaki oyunculara uygun olmayan görselleri devre dışı\nbırakmak için bu sekmeye tıklayın ve parolayı girin."
"[english]GameUI_ContentLockLabel"	"Press this button and enter password to disable\nvisuals inappropriate for younger players."
"GameUI_ContentStatusDisabled"	"İçerik kilidini etkinleştirmek için bir parola girin."
"[english]GameUI_ContentStatusDisabled"	"Enter a password to enable the content lock."
"GameUI_ContentStatusEnabled"	"İçerik kilidini devre dışı bırakmak için parolayı girin."
"[english]GameUI_ContentStatusEnabled"	"Enter a password to disable the content lock."
"GameUI_Enable"	"Etkinleştir"
"[english]GameUI_Enable"	"Enable"
"GameUI_Disable"	"Devre dışı bırak"
"[english]GameUI_Disable"	"Disable"
"GameUI_PasswordPrompt"	"Lütfen bir parola girin"
"[english]GameUI_PasswordPrompt"	"Please enter a password"
"GameUI_PasswordDisablePrompt"	"Lütfen parolayı girin"
"[english]GameUI_PasswordDisablePrompt"	"Please enter password"
"GameUI_PasswordReentryPrompt"	"Parolayı tekrar girin"
"[english]GameUI_PasswordReentryPrompt"	"Re-enter a password"
"GameUI_Cancel"	"İptal"
"[english]GameUI_Cancel"	"Cancel"
"GameUI_Back"	"Geri"
"[english]GameUI_Back"	"Back"
"GameUI_Apply"	"Uygula"
"[english]GameUI_Apply"	"Apply"
"GameUI_DemoPlayer"	"Demo Oynatıcı"
"[english]GameUI_DemoPlayer"	"Demo Player"
"GameUI_LoadDemo"	"Demo Dosyasını Seç"
"[english]GameUI_LoadDemo"	"Choose Demo File"
"GameUI_Load"	"Yükle"
"[english]GameUI_Load"	"Load"
"GameUI_DemoFile"	"Demo Dosyası"
"[english]GameUI_DemoFile"	"Demo File"
"GameUI_Map"	"Harita"
"[english]GameUI_Map"	"Map"
"GameUI_Close"	"Kapat"
"[english]GameUI_Close"	"Close"
"GameUI_NeverShowButton"	"Bu uyarıyı bir daha gösterme"
"[english]GameUI_NeverShowButton"	"Do not show this dialog again"
"GameUI_BonusMapsHelp"	"Aşağıdan bir bonus harita veya klasör seçin ve 'Yükle' tuşuna tıklayın"
"[english]GameUI_BonusMapsHelp"	"Select a bonus map or folder below, then click 'Load'"
"GameUI_BonusMaps"	"BONUS HARİTALAR"
"[english]GameUI_BonusMaps"	"BONUS MAPS"
"GameUI_BonusMapsCompletion"	"Tamamlandı"
"[english]GameUI_BonusMapsCompletion"	"Complete"
"GameUI_BonusMapsUnlocked"	"+Bonus"
"[english]GameUI_BonusMapsUnlocked"	"+Bonus"
"GameUI_BonusMapsStandard"	"Standart"
"[english]GameUI_BonusMapsStandard"	"Standard"
"GameUI_BonusMapsAdvanced"	"Gelişmiş"
"[english]GameUI_BonusMapsAdvanced"	"Advanced"
"GameUI_BonusMapsBest"	"En İyi: %s1"
"[english]GameUI_BonusMapsBest"	"Best: %s1"
"GameUI_BonusMapsGoal"	"Hedef: %s1"
"[english]GameUI_BonusMapsGoal"	"Goal: %s1"
"GameUI_LoadGameHelp"	"Aşağıdaki dosyadan kaydedilmiş bir oyunu seçin ve 'Oyunu yükle'ye tıklayın."
"[english]GameUI_LoadGameHelp"	"Select a saved game in the list below, then click 'Load game'."
"GameUI_LoadGame"	"KAYDI YÜKLE"
"[english]GameUI_LoadGame"	"LOAD GAME"
"GameUI_MultiplayerAdvanced"	"GELİŞMİŞ ÇOK OYUNCULU"
"[english]GameUI_MultiplayerAdvanced"	"MULTIPLAYER ADVANCED"
"GameUI_MultiplayerCustomize"	"Çok Oyunculuğu Özelleştir"
"[english]GameUI_MultiplayerCustomize"	"Multiplayer Customize"
"GameUI_Multiplayer"	"Çok Oyunculu"
"[english]GameUI_Multiplayer"	"Multiplayer"
"GameUI_OK"	"Tamam"
"[english]GameUI_OK"	"OK"
"GameUI_AdvancedEllipsis"	"Gelişmiş..."
"[english]GameUI_AdvancedEllipsis"	"Advanced..."
"GameUI_AdvancedNoEllipsis"	"Gelişmiş"
"[english]GameUI_AdvancedNoEllipsis"	"Advanced"
"GameUI_PlayerName"	"Oyuncu adı"
"[english]GameUI_PlayerName"	"Player name"
"GameUI_PrimaryColor"	"Ana renk"
"[english]GameUI_PrimaryColor"	"Primary color"
"GameUI_SecondaryColor"	"İkinci renk"
"[english]GameUI_SecondaryColor"	"Secondary color"
"GameUI_HighModels"	"Yüksek kaliteli modelleri kullan"
"[english]GameUI_HighModels"	"Use high quality models"
"GameUI_PlayerModel"	"Oyuncu modeli"
"[english]GameUI_PlayerModel"	"Player model"
"GameUI_SpraypaintImage"	"Sprey boya resmi"
"[english]GameUI_SpraypaintImage"	"Spraypaint image"
"GameUI_SpraypaintServerNote"	"Bir sunucuya katıldığınız zaman, sprey boya resmindeki değişiklikler etkin hâle gelecektir."
"[english]GameUI_SpraypaintServerNote"	"Changes to your spraypaint image take effect when you join a server."
"GameUI_NewGame"	"YENİ OYUN"
"[english]GameUI_NewGame"	"NEW GAME"
"GameUI_NewGameHelpText"	"Zorluk derecesini veya eğitim odasını seçin\nve 'Oyna'ya tıklayın."
"[english]GameUI_NewGameHelpText"	"Select a level of difficulty or the Training\nroom, then click 'Play'."
"GameUI_TrainingRoom"	"EĞİTİM ODASI"
"[english]GameUI_TrainingRoom"	"TRAINING ROOM"
"GameUI_Easy"	"Kolay"
"[english]GameUI_Easy"	"Easy"
"GameUI_Medium"	"Orta"
"[english]GameUI_Medium"	"Medium"
"GameUI_Hard"	"Zor"
"[english]GameUI_Hard"	"Hard"
"GameUI_SelectSkill"	"MÜCADELE ZORLUĞUNU SEÇ"
"[english]GameUI_SelectSkill"	"SELECT COMBAT DIFFICULTY"
"GameUI_StartNewGame"	"Yeni oyun başlat"
"[english]GameUI_StartNewGame"	"Start new game"
"GameUI_Next"	"Dahası >"
"[english]GameUI_Next"	"More >"
"GameUI_Prev"	"< Dahası"
"[english]GameUI_Prev"	"< More"
"GameUI_Play"	"Oyna"
"[english]GameUI_Play"	"Play"
"GameUI_EnableEAX"	"EAX Donanım Desteğini Etkinleştir"
"[english]GameUI_EnableEAX"	"Enable EAX Hardware Support"
"GameUI_EnableA3D"	"A3D Donanım Desteğini Etkinleştir"
"[english]GameUI_EnableA3D"	"Enable A3D Hardware Support"
"GameUI_SoundEffectVolume"	"Oyun sesi"
"[english]GameUI_SoundEffectVolume"	"Game volume"
"GameUI_HEVSuitVolume"	"TOG ses seviyesi"
"[english]GameUI_HEVSuitVolume"	"HEV suit volume"
"GameUI_MP3Volume"	"MP3 ses seviyesi *"
"[english]GameUI_MP3Volume"	"MP3 volume *"
"GameUI_MusicVolume"	"Müzik sesi"
"[english]GameUI_MusicVolume"	"Music volume"
"GameUI_SoundQuality"	"Ses kalitesi"
"[english]GameUI_SoundQuality"	"Sound quality"
"GameUI_Ultra"	"Çok Yüksek"
"[english]GameUI_Ultra"	"Very High"
"GameUI_High"	"Yüksek"
"[english]GameUI_High"	"High"
"GameUI_Low"	"Düşük"
"[english]GameUI_Low"	"Low"
"GameUI_UseDefaults"	"Varsayılanı Kullan"
"[english]GameUI_UseDefaults"	"Use Defaults"
"GameUI_SetNewKey"	"Tuşu düzenle"
"[english]GameUI_SetNewKey"	"Edit key"
"GameUI_ClearKey"	"Tuşu sil"
"[english]GameUI_ClearKey"	"Clear Key"
"GameUI_SetNewButton"	"Bir tuşa basın..."
"[english]GameUI_SetNewButton"	"Press a button..."
"GameUI_ClearButton"	"Temizle"
"[english]GameUI_ClearButton"	"Clear"
"GameUI_DefaultButtons"	"Varsayılan kontroller"
"[english]GameUI_DefaultButtons"	"Default controls"
"GameUI_Action"	"Eylem"
"[english]GameUI_Action"	"Action"
"GameUI_Toggle"	"Geçiş"
"[english]GameUI_Toggle"	"Toggle"
"GameUI_Hold"	"Tut"
"[english]GameUI_Hold"	"Hold"
"GameUI_KeyButton"	"TUŞ/SEKME"
"[english]GameUI_KeyButton"	"KEY/BUTTON"
"GameUI_Alternate"	"ALTERNATİF"
"[english]GameUI_Alternate"	"ALTERNATE"
"GameUI_Windowed"	"Pencerede çalıştır"
"[english]GameUI_Windowed"	"Run in a window"
"GameUI_Renderer"	"Derleyici"
"[english]GameUI_Renderer"	"Renderer"
"GameUI_Software"	"Yazılım"
"[english]GameUI_Software"	"Software"
"GameUI_OpenGL"	"OpenGL"
"[english]GameUI_OpenGL"	"OpenGL"
"GameUI_D3D"	"D3D"
"[english]GameUI_D3D"	"D3D"
"GameUI_Brightness"	"Parlaklık"
"[english]GameUI_Brightness"	"Brightness"
"GameUI_Gamma"	"Kontrast"
"[english]GameUI_Gamma"	"Gamma"
"GameUI_Resolution"	"Çözünürlük"
"[english]GameUI_Resolution"	"Resolution"
"GameUI_VideoRestart"	"Not: Görüntü seçeneklerini değiştirmek oyundan çıkmaya ve oyunu yeniden başlatmaya neden olacaktır."
"[english]GameUI_VideoRestart"	"Note: changing video options will cause the game to exit and restart."
"GameUI_EnableVoice"	"Sesli iletişimi etkinleştir"
"[english]GameUI_EnableVoice"	"Enable voice in this game"
"GameUI_BoostMicrophone"	"Mikrofon sesini yükselt"
"[english]GameUI_BoostMicrophone"	"Boost microphone gain"
"GameUI_MicrophoneVolume"	"Mikrofon Sesi"
"[english]GameUI_MicrophoneVolume"	"Microphone Volume"
"GameUI_ReceiveVolume"	"Alınan Ses"
"[english]GameUI_ReceiveVolume"	"Receive Volume"
"GameUI_TestMicrophone"	"Mikrofonu Test Et"
"[english]GameUI_TestMicrophone"	"Test Microphone"
"GameUI_StopTestMicrophone"	"Mikrofon Testini Durdur"
"[english]GameUI_StopTestMicrophone"	"Stop Microphone Test"
"GameUI_VoiceReceiveVolume"	"Ses alım şiddeti *"
"[english]GameUI_VoiceReceiveVolume"	"Voice receive volume *"
"GameUI_VoiceTransmitVolume"	"Ses iletim şiddeti *"
"[english]GameUI_VoiceTransmitVolume"	"Voice transmit volume *"
"GameUI_SaveGame"	"OYUN KAYDI"
"[english]GameUI_SaveGame"	"SAVE GAME"
"GameUI_SaveGameHelp"	"Yeni bir dosya oluşturmak için listedeki 'Yeni oyun kaydı'nı seçin veya önceden\nkaydedilmiş dosyanın üzerine yazın."
"[english]GameUI_SaveGameHelp"	"Select 'New Save Game' in the list to create a new file, or select\na previously saved game to overwrite a file."
"GameUI_Delete"	"Sil"
"[english]GameUI_Delete"	"Delete"
"GameUI_Quit"	"Oyundan Çık"
"[english]GameUI_Quit"	"Quit game"
"GameUI_SteamPassword"	"Steam Parolası"
"[english]GameUI_SteamPassword"	"Steam Password"
"GameUI_CreateServer"	"SUNUCU OLUŞTUR"
"[english]GameUI_CreateServer"	"CREATE SERVER"
"GameUI_Start"	"Başlat"
"[english]GameUI_Start"	"Start"
"GameUI_Console"	"Konsol"
"[english]GameUI_Console"	"Console"
"GameUI_Submit"	"Gönder"
"[english]GameUI_Submit"	"Submit"
"GameUI_Options"	"SEÇENEKLER"
"[english]GameUI_Options"	"OPTIONS"
"GameUI_Keyboard"	"Klavye"
"[english]GameUI_Keyboard"	"Keyboard"
"GameUI_Mouse"	"Fare"
"[english]GameUI_Mouse"	"Mouse"
"GameUI_Audio"	"Ses"
"[english]GameUI_Audio"	"Audio"
"GameUI_Video"	"Görüntü"
"[english]GameUI_Video"	"Video"
"GameUI_Voice"	"İletişim"
"[english]GameUI_Voice"	"Voice"
"GameUI_Advanced"	"Kilit"
"[english]GameUI_Advanced"	"Lock"
"GameUI_Server"	"Sunucu"
"[english]GameUI_Server"	"Server"
"GameUI_Game"	"Oyun"	[$WIN32]
"[english]GameUI_Game"	"Game"
"GameUI_SavedGame"	"Kaydedilmiş Oyun"
"[english]GameUI_SavedGame"	"Saved Game"
"GameUI_ElapsedTime"	"Geçen Süre"
"[english]GameUI_ElapsedTime"	"Elapsed Time"
"GameUI_TimeStamp"	"Zaman Göstergesi"
"[english]GameUI_TimeStamp"	"Time Stamp"
"GameUI_KeyboardSettings"	"Klavye ayarları"
"[english]GameUI_KeyboardSettings"	"Keyboard settings"
"GameUI_KeyboardSettingsText"	"Tüm eylemler varsayılan tuşlarına geri dönsün mü?"
"[english]GameUI_KeyboardSettingsText"	"Reset all actions to use their default keys?"
"GameUI_ControllerSettingsText"	"Tüm oyun kumandası seçenekleri varsayılanlarına dönsün mü?"
"[english]GameUI_ControllerSettingsText"	"Reset all controller options to their defaults?"
"GameUI_GameMenu_NewGame"	"YENİ OYUN"
"[english]GameUI_GameMenu_NewGame"	"NEW GAME"
"GameUI_GameMenu_PlayDemo"	"DEMOYU OYNAT"
"[english]GameUI_GameMenu_PlayDemo"	"PLAY DEMO"
"GameUI_GameMenu_BonusMaps"	"BONUS HARİTALAR"
"[english]GameUI_GameMenu_BonusMaps"	"BONUS MAPS"
"GameUI_GameMenu_LoadGame"	"KAYDI YÜKLE"
"[english]GameUI_GameMenu_LoadGame"	"LOAD GAME"
"GameUI_GameMenu_SaveGame"	"OYUN KAYDI"
"[english]GameUI_GameMenu_SaveGame"	"SAVE GAME"
"GameUI_GameMenu_Multiplayer"	"ÇOK OYUNCULU"
"[english]GameUI_GameMenu_Multiplayer"	"MULTIPLAYER "
"GameUI_GameMenu_FindServers"	"SUNUCULARI BUL"
"[english]GameUI_GameMenu_FindServers"	"FIND SERVERS"
"GameUI_GameMenu_Friends"	"ARKADAŞLAR"
"[english]GameUI_GameMenu_Friends"	"FRIENDS"
"GameUI_GameMenu_Customize"	"ÖZELLEŞTİR"
"[english]GameUI_GameMenu_Customize"	"CUSTOMIZE"
"GameUI_GameMenu_CreateServer"	"SUNUCU OLUŞTUR"
"[english]GameUI_GameMenu_CreateServer"	"CREATE SERVER"
"GameUI_GameMenu_Options"	"SEÇENEKLER"
"[english]GameUI_GameMenu_Options"	"OPTIONS"
"GameUI_GameMenu_Achievements"	"BAŞARIMLAR"
"[english]GameUI_GameMenu_Achievements"	"ACHIEVEMENTS"
"GameUI_GameMenu_PlayerStats"	"OYUNCU İSTATİSTİKLERİ"
"[english]GameUI_GameMenu_PlayerStats"	"PLAYER STATS"
"GameUI_GameMenu_Quit"	"ÇIKIŞ"
"[english]GameUI_GameMenu_Quit"	"QUIT"
"GameUI_PasswordsDontMatch"	"Girilen parolalar uyuşmuyor!"
"[english]GameUI_PasswordsDontMatch"	"Entered passwords don't match!"
"GameUI_MustEnterPassword"	"Bir parola girmelisiniz"
"[english]GameUI_MustEnterPassword"	"You must enter a password"
"GameUI_IncorrectPassword"	"Hatalı parola"
"[english]GameUI_IncorrectPassword"	"Incorrect password"
"GameUI_CantDisableContentCtrl"	"Devre dışı bırakılamıyor, içerik denetimi ayarlanmamış"
"[english]GameUI_CantDisableContentCtrl"	"Can't disable, content control was not set"
"GameUI_Loading"	"YÜKLENİYOR..."
"[english]GameUI_Loading"	"LOADING..."
"GameUI_LoadingGame"	"YÜKLENİYOR"
"[english]GameUI_LoadingGame"	"LOADING"
"GameUI_Disconnected"	"Bağlantı kesildi"
"[english]GameUI_Disconnected"	"Disconnected"
"GameUI_ConnectionFailed"	"Sunucuyla bağlantı kurulamıyor."
"[english]GameUI_ConnectionFailed"	"Could not connect to server."
"GameUI_DisconnectedFrom"	"Sunucuyla olan bağlantınız kesildi."
"[english]GameUI_DisconnectedFrom"	"You have been disconnected from the server."
"GameUI_DisconnectedFromServerExtended"	"Sunucuyla olan bağlantınız kesildi.\nNeden: %s1"
"[english]GameUI_DisconnectedFromServerExtended"	"You have been disconnected from the server.\nReason: %s1"
"GameUI_EstablishingConnection"	"Sunucuyla olan ağ bağlantısı kuruluyor..."
"[english]GameUI_EstablishingConnection"	"Establishing network connection to server..."
"GameUI_ParseServerInfo"	"Sunucu bilgileri ayrıştırılıyor..."
"[english]GameUI_ParseServerInfo"	"Parsing server info..."
"GameUI_CheckCRCs"	"Oyun kaynakları doğrulanıyor..."
"[english]GameUI_CheckCRCs"	"Validating game resources..."
"GameUI_PrecacheResources"	"Oyun kaynakları yükleniyor..."
"[english]GameUI_PrecacheResources"	"Loading game resources..."
"GameUI_ParseBaseline"	"Sunucu bilgileri ayrıştırılıyor..."
"[english]GameUI_ParseBaseline"	"Parsing game info..."
"GameUI_StartingServer"	"Yerel oyun sunucusu başlatılıyor..."
"[english]GameUI_StartingServer"	"Starting local game server..."
"GameUI_DisplayMode"	"Görüntü modu"
"[english]GameUI_DisplayMode"	"Display mode"
"GameUI_Fullscreen"	"Tam ekran"
"[english]GameUI_Fullscreen"	"Full screen"
"GameUI_AspectRatio"	"Görüntü Oranı"
"[english]GameUI_AspectRatio"	"Aspect Ratio"
"GameUI_AspectNormal"	"Normal (4:3)"
"[english]GameUI_AspectNormal"	"Normal (4:3)"
"GameUI_AspectWide16x9"	"Geniş ekran 16:9"
"[english]GameUI_AspectWide16x9"	"Widescreen 16:9"
"GameUI_AspectWide16x10"	"Geniş ekran 16:10"
"[english]GameUI_AspectWide16x10"	"Widescreen 16:10"
"GameUI_AspectWide"	"Geniş ekran"
"[english]GameUI_AspectWide"	"Widescreen"
"GameUI_CDKey"	"CD Anahtarı"
"[english]GameUI_CDKey"	"CD Key"
"GameUI_EnterCDKey"	"Lütfen, CD kabının üzerinde yazan CD Anahtarını girin."
"[english]GameUI_EnterCDKey"	"Please enter your CD Key, which can be\nfound printed on your CD jewel case."
"GameUI_LoadingDialog_ContentHosting"	"İçerik sağlayıcısı:"
"[english]GameUI_LoadingDialog_ContentHosting"	"Content hosting provided by:"
"GameUI_ColorSliders"	"Renkler"
"[english]GameUI_ColorSliders"	"Colors"
"GameUI_ColorQuality"	"Renk Kalitesi"
"[english]GameUI_ColorQuality"	"Color Quality"
"GameUI_CDKey_Invalid_Text"	"Girdiğiniz CD Anahtarı geçersiz."
"[english]GameUI_CDKey_Invalid_Text"	"The CD Key you have entered is invalid."
"GameUI_CDKey_Invalid_Title"	"HATALI CD ANAHTARI"
"[english]GameUI_CDKey_Invalid_Title"	"INCORRECT CD KEY"
"GameUI_CDKey_TooManyTries"	"Çok fazla sayıda geçersiz CD Anahtarı girildi. Çıkış yapılıyor..."
"[english]GameUI_CDKey_TooManyTries"	"Incorrect CD Key entered too many times. Exiting..."
"GameUI_GameMenu_ResumeGame"	"OYUNA DEVAM ET"
"[english]GameUI_GameMenu_ResumeGame"	"RESUME GAME"
"GameUI_GameMenu_Disconnect"	"BAĞLANTIYI KES"
"[english]GameUI_GameMenu_Disconnect"	"DISCONNECT"
"GameUI_GameMenu_ChangeGame"	"OYUN DEĞİŞTİR"
"[english]GameUI_GameMenu_ChangeGame"	"CHANGE GAME"
"GameUI_GameMenu_PlayerList"	"OYUNCULARI SUSTUR"
"[english]GameUI_GameMenu_PlayerList"	"MUTE PLAYERS"
"GameUI_OutOfDate_Title"	"OYUN GÜNCEL DEĞİL"
"[english]GameUI_OutOfDate_Title"	"GAME IS OUT OF DATE"
"GameUI_OutOfDate_URL"	"http://www.steampowered.com/autoupdate"
"[english]GameUI_OutOfDate_URL"	"http://www.steampowered.com/autoupdate"
"GameUI_OutOfDate_Msg"	"Oyununuz güncel değil. Valve'in internet sayfasından en yeni güncellemeleri indirmek için Tamam'a tıklayın."
"[english]GameUI_OutOfDate_Msg"	"Your game is out of date.\nClick OK to go to Valve's webpage to download the latest updates."
"GameUI_QuitConfirmationTitle"	"OYUNDAN ÇIK"
"[english]GameUI_QuitConfirmationTitle"	"QUIT GAME"
"GameUI_QuitConfirmationText"	"Oyundan çıkmak istiyor musunuz?"
"[english]GameUI_QuitConfirmationText"	"Do you wish to stop playing now?"
"GameUI_Disconnect"	"Bağlantıyı kes"
"[english]GameUI_Disconnect"	"Disconnect"
"GameUI_DisconnectConfirmationText"	"Bu oyunu bırakmak istediğinize emin misiniz?"
"[english]GameUI_DisconnectConfirmationText"	"Are you sure you want to leave this game?"
"GameUI_DisconnectHostConfirmationText"	"Bağlantıyı kesmek tüm oyuncuları sunucudan atacaktır. Bu oyunu bırakmak istediğinize emin misiniz?"
"[english]GameUI_DisconnectHostConfirmationText"	"Disconnecting will kick all players. Are you sure you want to leave this game?"
"GameUI_ChangeGame"	"Oyunu değiştir"
"[english]GameUI_ChangeGame"	"Change game"
"GameUI_NoOtherGamesAvailable"	"Geçerli başka oyun yok."
"[english]GameUI_NoOtherGamesAvailable"	"There are no other games available to play."
"GameUI_ForceGameRestart"	"Oyun değişimi, oyun motorunu yeniden başlatmaya neden olacaktır."
"[english]GameUI_ForceGameRestart"	"Changing games will cause the engine to restart."
"GameUI_Miles_Voice"	"Miles Ses Sistemi kullanılmaktadır. Telif hakkı © 1991-2001 RAD Game Tools, Inc.'e aittir"
"[english]GameUI_Miles_Voice"	"Uses Miles Sound System. Copyright © 1991-2001 by RAD Game Tools, Inc."
"GameUI_Miles_Audio"	"MPEG Layer-3 seslendirmesi Miles Sound System RAD Game Tools tarafından Miles Sound System kaynağı ile yapılmıştır, Inc. MPEG Layer-3 ses sıkıştırma teknolojisi Fraunhofer IIS ve THOMSON multimedya tarafından lisanslıdır."
"[english]GameUI_Miles_Audio"	"MPEG Layer-3 playback supplied with the Miles Sound System from RAD Game Tools, Inc. MPEG Layer-3 audio compression technology licensed by Fraunhofer IIS and THOMSON multimedia."
"GameUI_Bink"	"Bink Video kullanır. Telif Hakkı © 1997-2007 RAD Game Tools, Inc firmasına aittir."
"[english]GameUI_Bink"	"Uses Bink Video. Copyright © 1997-2007 by RAD Game Tools, Inc."
"GameUI_MuteIngameVoice"	"Sustur"
"[english]GameUI_MuteIngameVoice"	"Mute in-game voice"
"GameUI_UnmuteIngameVoice"	"Sesini aç"
"[english]GameUI_UnmuteIngameVoice"	"Unmute in-game voice"
"GameUI_PlayerListDialogTitle"	"MEVCUT OYUNCULAR - %server%"
"[english]GameUI_PlayerListDialogTitle"	"CURRENT PLAYERS - %server%"
"GameUI_FriendsName"	"Arkadaş isimleri"
"[english]GameUI_FriendsName"	"Friends name"
"GameUI_Properties"	"Özellikler"
"[english]GameUI_Properties"	"Properties"
"GameUI_AddFriendTitle"	"ARKADAŞLAR - ARKADAŞ EKLE"
"[english]GameUI_AddFriendTitle"	"FRIENDS - ADD FRIEND"
"GameUI_FriendAddedToList"	"%name% arkadaş listenize eklendi. Arkadaşlık talebiniz kabul\nedilene kadar bu kişilerin çevrimiçi olarak görünmeyeceklerini unutmayın."
"[english]GameUI_FriendAddedToList"	"%name% has been added to your friends list.\nNote that they will not show up as online until they have accepted your friendship request."
"GameUI_AddFriendFailed"	"%name% arkadaş listenize eklenemedi.\nBir bağlantı hatası oluştu veya bu kişi Arkadaşlar özelliğini kullanmıyor."
"[english]GameUI_AddFriendFailed"	"%name% could not be added to your list.\nThere was either a connection error, or they are not running Friends."
"GameUI_NoOtherPlayersInGame"	"Oyunda başka oyuncu yok."
"[english]GameUI_NoOtherPlayersInGame"	"There are no other players in the game."
"GameUI_QuickSave"	"HIZLI KAYIT"
"[english]GameUI_QuickSave"	"QUICK SAVE"
"GameUI_AutoSave"	"OTOMATİK KAYIT"
"[english]GameUI_AutoSave"	"AUTO SAVE"
"GameUI_AutoSaveLabel"	"OTOMATİK:"
"[english]GameUI_AutoSaveLabel"	"AUTO:"
"GameUI_UserSaveLabel"	"KULLANICI:"
"[english]GameUI_UserSaveLabel"	"USER:"
"GameUI_Type"	"Tür"
"[english]GameUI_Type"	"Type"
"GameUI_ServerName"	"Sunucu adı"
"[english]GameUI_ServerName"	"Server name"
"GameUI_MaxPlayers"	"Azami oyuncu adedi:"
"[english]GameUI_MaxPlayers"	"Max. Players:"
"GameUI_Password"	"Parola"
"[english]GameUI_Password"	"Password"
"GameUI_DARK"	"KARANLIK"
"[english]GameUI_DARK"	"DARK"
"GameUI_LIGHT"	"AYDINLIK"
"[english]GameUI_LIGHT"	"LIGHT"
"GameUI_VerifyingResources"	"Kaynaklar doğrulanıyor..."
"[english]GameUI_VerifyingResources"	"Verifying resources..."
"GameUI_VerifyingAndDownloading"	"Kaynaklar doğrulanıyor ve indiriliyor..."
"[english]GameUI_VerifyingAndDownloading"	"Verifying and downloading resources..."
"GameUI_UpdatingSteamResources"	"Steam kaynakları güncelleniyor"
"[english]GameUI_UpdatingSteamResources"	"Updating steam resources"
"GameUI_DownloadFailed"	"%s1 indirilemiyor"
"[english]GameUI_DownloadFailed"	"Could not download %s1"
"GameUI_DownloadFailedZeroLen"	"%s1 indirilemiyor:\nDosyada veri yok"
"[english]GameUI_DownloadFailedZeroLen"	"Could not download %s1:\nFile has no data"
"GameUI_DownloadFailedConClosed"	"%s1 indirilemiyor:\nBağlantı uzak sunucu tarafından kesildi"
"[english]GameUI_DownloadFailedConClosed"	"Could not download %s1:\nConnection closed by remote host"
"GameUI_DownloadFailedBadURL"	"%s1 indirilemiyor:\nGeçersiz Bağlantı Adresi"
"[english]GameUI_DownloadFailedBadURL"	"Could not download %s1:\nInvalid URL"
"GameUI_DownloadFailedBadProtocol"	"%s1 indirilemiyor:\nSadece HTTP desteği var"
"[english]GameUI_DownloadFailedBadProtocol"	"Could not download %s1:\nOnly HTTP is supported"
"GameUI_DownloadFailedCantBind"	"%s1 indirilemiyor:\nGirdiye bağlanılamadı"
"[english]GameUI_DownloadFailedCantBind"	"Could not download %s1:\nCannot bind a socket"
"GameUI_DownloadFailedCantConnect"	"%s1 indirilemiyor:\nSunucuya bağlanılamadı"
"[english]GameUI_DownloadFailedCantConnect"	"Could not download %s1:\nCannot connect to server"
"GameUI_DownloadFailedNoHeaders"	"%s1 indirilemiyor:\nSunucudan dosya bilgisi alınamıyor"
"[english]GameUI_DownloadFailedNoHeaders"	"Could not download %s1:\nCannot get file info from server"
"GameUI_DownloadFailedFileNotFound"	"%s1 indirilemiyor:\nDosya mevcut değil"
"[english]GameUI_DownloadFailedFileNotFound"	"Could not download %s1:\nFile does not exist"
"GameUI_CurrentPlayers"	"OYUNCULARI SUSTUR"
"[english]GameUI_CurrentPlayers"	"MUTE PLAYERS"
"GameUI_LoadingFilename"	"%s1 yükleniyor ..."
"[english]GameUI_LoadingFilename"	"Loading %s1 ..."
"GameUI_EventList"	"Etkinlik Listesi"
"[english]GameUI_EventList"	"Event List"
"GameUI_EditDirectorCommand"	"Yönetici komutlarını düzenle"
"[english]GameUI_EditDirectorCommand"	"Edit director command"
"GameUI_GetTime"	"Süre al"
"[english]GameUI_GetTime"	"Get time"
"GameUI_GetView"	"Görüntü al"
"[english]GameUI_GetView"	"Get view"
"GameUI_Add"	"Ekle"
"[english]GameUI_Add"	"Add"
"GameUI_Remove"	"Kaldır"
"[english]GameUI_Remove"	"Remove"
"GameUI_Modify"	"Değiştir"
"[english]GameUI_Modify"	"Modify"
"GameUI_Goto"	"Git"
"[english]GameUI_Goto"	"Goto"
"GameUI_Events"	"Etkinlikler"
"[english]GameUI_Events"	"Events"
"GameUI_Save"	"Kaydet"
"[english]GameUI_Save"	"Save"
"GameUI_Time"	"Süre"
"[english]GameUI_Time"	"Time"
"GameUI_CPUPlayerOptions"	"CPU Oyuncu Seçenekleri"
"[english]GameUI_CPUPlayerOptions"	"CPU Player Options"
"GameUI_MediumBitDepth"	"Orta (16 bit)"
"[english]GameUI_MediumBitDepth"	"Medium (16 bit)"
"GameUI_HighBitDepth"	"En yüksek (32 bit)"
"[english]GameUI_HighBitDepth"	"Highest (32 bit)"
"GameUI_PrecachingResources"	"Önbellek kaynakları oluşturuluyor..."
"[english]GameUI_PrecachingResources"	"Precaching resources..."
"GameUI_LoadingSecurityModule"	"Güvenlik birimi yükleniyor..."
"[english]GameUI_LoadingSecurityModule"	"Loading security module..."
"GameUI_SecurityModule"	"Güvenlik birimi"
"[english]GameUI_SecurityModule"	"Security module"
"GameUI_DownloadingSecurityModule"	"Güvenlik birimi indiriliyor"
"[english]GameUI_DownloadingSecurityModule"	"Downloading security module"
"GameUI_ErrorLoadingSecurityModule"	"Güvenlik birimi indirme hatası."
"[english]GameUI_ErrorLoadingSecurityModule"	"Error loading security module."
"GameUI_FailedDownloadSecurityModule"	"Güvenlik birimi indirme işlemi başarısız."
"[english]GameUI_FailedDownloadSecurityModule"	"Failed to download security module."
"GameUI_ServerConnectionTimeout"	"Sunucuya bağlanma zaman aşımına uğradı."
"[english]GameUI_ServerConnectionTimeout"	"Connection to server timed out."
"GameUI_ServerConnectionFailedBadPassword"	"Sunucuya bağlantı reddedildi.\nGirdiğiniz parola hatalı."
"[english]GameUI_ServerConnectionFailedBadPassword"	"Connection to game server refused.\nThe password you entered was incorrect."
"GameUI_SaveGame_NewSavedGame"	"Yeni oyun kaydı"
"[english]GameUI_SaveGame_NewSavedGame"	"New saved game"
"GameUI_SaveGame_NewSave"	"Yeni Kayıt"
"[english]GameUI_SaveGame_NewSave"	"New Save"
"GameUI_SaveGame_New"	"Yeni"
"[english]GameUI_SaveGame_New"	"New"
"GameUI_SaveGame_Current"	"Mevcut"
"[english]GameUI_SaveGame_Current"	"Current"
"GameUI_SaveGame_Overwrite"	"Kaydın Üzerine Yaz"
"[english]GameUI_SaveGame_Overwrite"	"Overwrite Save"
"GameUI_Headphones"	"Kulaklık"
"[english]GameUI_Headphones"	"Headphones"
"GameUI_2Speakers"	"2 Hoparlör"
"[english]GameUI_2Speakers"	"2 Speakers"
"GameUI_4Speakers"	"4 Hoparlör"
"[english]GameUI_4Speakers"	"4 Speakers"
"GameUI_5Speakers"	"5.1 Hoparlör"
"[english]GameUI_5Speakers"	"5.1 Speakers"
"GameUI_7Speakers"	"7.1 Hoparlör"
"[english]GameUI_7Speakers"	"7.1 Speakers"
"GameUI_SpeakerConfiguration"	"Hoparlör yapılandırması"
"[english]GameUI_SpeakerConfiguration"	"Speaker configuration"
"GameUI_NewSaveGame"	"YENİ OYUN KAYDI"
"[english]GameUI_NewSaveGame"	"NEW SAVE GAME"
"GameUI_ConfirmDeleteSaveGame_Title"	"OYUN KAYDINI SİL?"
"[english]GameUI_ConfirmDeleteSaveGame_Title"	"DELETE SAVE GAME?"
"GameUI_ConfirmDeleteSaveGame_Info"	"Bu oyun kaydını silmek istediğinize emin misiniz?\nBu kayıt kalıcı olarak silinecek."
"[english]GameUI_ConfirmDeleteSaveGame_Info"	"Do you want to delete this save game?\nIt will be deleted permanently."
"GameUI_ConfirmDeleteSaveGame_OK"	"Sil"
"[english]GameUI_ConfirmDeleteSaveGame_OK"	"Delete"
"GameUI_ConfirmOverwriteSaveGame_Title"	"OYUN KAYDI"
"[english]GameUI_ConfirmOverwriteSaveGame_Title"	"SAVE GAME"
"GameUI_ConfirmOverwriteSaveGame_Info"	"Daha önceden oluşturulmuş bu oyun kaydının üzerine yazmak istiyor musunuz?"
"[english]GameUI_ConfirmOverwriteSaveGame_Info"	"Do you want to overwrite this existing save game?"
"GameUI_ConfirmOverwriteSaveGame_OK"	"Üzerine Yaz"
"[english]GameUI_ConfirmOverwriteSaveGame_OK"	"Overwrite"
"GameUI_SavingWarning"	"İçerik kaydediliyor.\nLütfen konsolunuzu kapatmayın."
"[english]GameUI_SavingWarning"	"Saving content.\nPlease don't turn off your console."
"GameUI_GameSaved"	"Oyun Kaydedildi"
"[english]GameUI_GameSaved"	"Game Saved"
"GameUI_AutoSave_Console_Explanation"	"Bu oyun otomatik kayıt sistemi kullandığı için oyununuz belirli aralıklarla size haber verilmeksizin kaydedilecektir. Lütfen otomatik kayıt işlemi sırasında Xbox konsolunuzu kapatmayın."
"[english]GameUI_AutoSave_Console_Explanation"	"This game uses an autosave system that will periodically save your progress without warning. Please do not turn off your Xbox console during an autosave."
"GameUI_ConfirmLoadGame_Title"	"KAYDI YÜKLE"
"[english]GameUI_ConfirmLoadGame_Title"	"LOAD GAME"
"GameUI_LoadWarning"	"Yükleme yapmak istediğinize emin misiniz?\nKaydedilmemiş verilerinizin tümü kaybolacak."
"[english]GameUI_LoadWarning"	"Are you sure you want to load?\nAll unsaved progress will be lost."
"GameUI_ConfirmNewGame_Title"	"YENİ OYUN"
"[english]GameUI_ConfirmNewGame_Title"	"NEW GAME"
"GameUI_NewGameWarning"	"Yeni bir oyun başlatmak istediğinize emin misiniz?\nKaydedilmemiş verilerinizin tümü kaybolacak."
"[english]GameUI_NewGameWarning"	"Are you sure you want to start a new game?\nAll unsaved progress will be lost."
"GameUI_RandomMap"	"< Rastgele Harita >"
"[english]GameUI_RandomMap"	"< Random Map >"
"GameUI_RetryingConnectionToServer"	"Tekrar sunucuya bağlanılmaya çalışılıyor..."
"[english]GameUI_RetryingConnectionToServer"	"Retrying connection to server..."
"GameUI_RetryingConnectionToServer2"	"Tekrar sunucuya bağlanılmaya çalışılıyor (2)..."
"[english]GameUI_RetryingConnectionToServer2"	"Retrying connection to server (2)..."
"GameUI_RetryingConnectionToServer3"	"Tekrar sunucuya bağlanılmaya çalışılıyor (3)..."
"[english]GameUI_RetryingConnectionToServer3"	"Retrying connection to server (3)..."
"GameUI_CouldNotContactGameServer"	"Sunucuyla bağlantı kurulamadı"
"[english]GameUI_CouldNotContactGameServer"	"Failed to contact game server"
"GameUI_RefreshLogin_InfoTicketExpired"	"Steam oturumunuzun süresi dolmuş.\nDevam etmek için lütfen parolanızı tekrar giriniz."
"[english]GameUI_RefreshLogin_InfoTicketExpired"	"Your steam ticket has expired.\nPlease re-enter your password to continue."
"GameUI_RefreshLogin_UserName"	"Hesap adı"
"[english]GameUI_RefreshLogin_UserName"	"Account name"
"GameUI_RefreshLogin_Password"	"Parola"
"[english]GameUI_RefreshLogin_Password"	"Password"
"GameUI_RefreshLogin_Login"	"Giriş"
"[english]GameUI_RefreshLogin_Login"	"Login"
"GameUI_RefreshLogin_Cancel"	"İptal"
"[english]GameUI_RefreshLogin_Cancel"	"Cancel"
"GameUI_RefreshLogin"	"Girişi Yenile"
"[english]GameUI_RefreshLogin"	"Refresh Login"
"GameUI_RefreshLogin_RememberPassword"	"Parolamı hatırla"
"[english]GameUI_RefreshLogin_RememberPassword"	"Remember my password"
"GameUI_Login_ErrorTitle"	"Giriş Yenileme - Hata"
"[english]GameUI_Login_ErrorTitle"	"Refresh Login - Error"
"GameUI_ErrorLoginFailed"	"Giriş başarısız. Lütfen tekrar deneyin."
"[english]GameUI_ErrorLoginFailed"	"Login Failed. Please try again."
"LoadingProgress_SpawningServer"	"Yerel sunucu başlatılıyor..."
"[english]LoadingProgress_SpawningServer"	"Starting local game server..."
"LoadingProgress_LoadMap"	"Mekan yükleniyor..."
"[english]LoadingProgress_LoadMap"	"Loading world..."
"LoadingProgress_PrecacheWorld"	"Mekan başlatılıyor..."
"[english]LoadingProgress_PrecacheWorld"	"Initializing world..."
"LoadingProgress_LoadResources"	"Kaynaklar yükleniyor..."
"[english]LoadingProgress_LoadResources"	"Loading resources..."
"LoadingProgress_SignonLocal"	"Kaynaklar başlatılıyor..."
"[english]LoadingProgress_SignonLocal"	"Initializing resources..."
"LoadingProgress_SignonDataLocal"	"Oyun verileri başlatılıyor..."
"[english]LoadingProgress_SignonDataLocal"	"Initializing game data..."
"LoadingProgress_BeginConnect"	"Sunucuyla bağlantı kuruluyor..."
"[english]LoadingProgress_BeginConnect"	"Establishing connection to server..."
"LoadingProgress_Connecting"	"Sunucuya bağlanılıyor..."
"[english]LoadingProgress_Connecting"	"Connecting to server..."
"LoadingProgress_ProcessServerInfo"	"Sunucu bilgileri alınıyor..."
"[english]LoadingProgress_ProcessServerInfo"	"Retrieving server info..."
"LoadingProgress_SendClientInfo"	"Alıcı bilgileri yollanıyor..."
"[english]LoadingProgress_SendClientInfo"	"Sending client info..."
"LoadingProgress_SignonData"	"Oyun verileri alınıyor..."
"[english]LoadingProgress_SignonData"	"Retrieving game data..."
"LoadingProgress_Changelevel"	"Sunucu bölümü değiştiriyor..."
"[english]LoadingProgress_Changelevel"	"Server is changing level..."
"GameUI_Difficulty"	"Zorluk derecesi"
"[english]GameUI_Difficulty"	"Difficulty"
"GameUI_SkillEasy"	"Kolay"
"[english]GameUI_SkillEasy"	"Easy"
"GameUI_SkillNormal"	"Normal"
"[english]GameUI_SkillNormal"	"Normal"
"GameUI_SkillHard"	"Zor"
"[english]GameUI_SkillHard"	"Hard"
"GameUI_SelectDifficulty"	"Mücadele zorluk derecesi:"
"[english]GameUI_SelectDifficulty"	"Combat difficulty:"
"GameUI_Portal"	"Portallar"
"[english]GameUI_Portal"	"Portals"
"GameUI_PortalDepthLabel"	"Portal render derinliği"
"[english]GameUI_PortalDepthLabel"	"Portal render depth"
"GameUI_PortalDepth0"	"0"
"[english]GameUI_PortalDepth0"	"0"
"GameUI_PortalDepth1"	"1"
"[english]GameUI_PortalDepth1"	"1"
"GameUI_PortalDepth2"	"2 (tavsiye edilen)"
"[english]GameUI_PortalDepth2"	"2 (recommended)"
"GameUI_PortalDepth3"	"3"
"[english]GameUI_PortalDepth3"	"3"
"GameUI_PortalDepth5"	"5"
"[english]GameUI_PortalDepth5"	"5"
"GameUI_PortalDepth6"	"6"
"[english]GameUI_PortalDepth6"	"6"
"GameUI_PortalDepth7"	"7"
"[english]GameUI_PortalDepth7"	"7"
"GameUI_PortalDepth8"	"8"
"[english]GameUI_PortalDepth8"	"8"
"GameUI_PortalDepth9"	"9"
"[english]GameUI_PortalDepth9"	"9"
"GameUI_PortalFunnel"	"Portal deliği"
"[english]GameUI_PortalFunnel"	"Portal funnel"
"GameUI_PortalFunnelLabel"	"Bilgisayar size portal oluşturmak için yardım edecektir"
"[english]GameUI_PortalFunnelLabel"	"The computer helps you aim into floor portals"
"GameUI_CrosshairDescription"	"Nişangâh görünümü"
"[english]GameUI_CrosshairDescription"	"Crosshair appearance"
"GameUI_Auto"	"Otomatik boyut"
"[english]GameUI_Auto"	"Auto-size"
"GameUI_Small"	"Küçük"
"[english]GameUI_Small"	"Small"
"GameUI_Large"	"Büyük"
"[english]GameUI_Large"	"Large"
"GameUI_Translucent"	"Saydam"
"[english]GameUI_Translucent"	"Translucent"
"GameUI_CrosshairRed"	"Kırmızı"
"[english]GameUI_CrosshairRed"	"Red"
"GameUI_CrosshairGreen"	"Yeşil"
"[english]GameUI_CrosshairGreen"	"Green"
"GameUI_CrosshairBlue"	"Mavi"
"[english]GameUI_CrosshairBlue"	"Blue"
"GameUI_CrosshairScale"	"Boyut"
"[english]GameUI_CrosshairScale"	"Size"
"GameUI_FastSwitchCheck"	"Hızlı silah değiştirme"
"[english]GameUI_FastSwitchCheck"	"Fast weapon switch"
"GameUI_DeveloperConsoleCheck"	"Geliştirici konsolunu etkinleştir"
"[english]GameUI_DeveloperConsoleCheck"	"Enable developer console"
"GameUI_KeyboardAdvanced_Title"	"KLAVYE - GELİŞMİŞ"
"[english]GameUI_KeyboardAdvanced_Title"	"KEYBOARD - ADVANCED"
"GameUI_OptionsRestartRequired_Title"	"SEÇENEKLER - YENİDEN BAŞLAT"
"[english]GameUI_OptionsRestartRequired_Title"	"OPTIONS - RESTART"
"GameUI_OptionsRestartRequired_Info"	"Yaptığınız değişiklikler oyunu yeniden başlatmayı\ngerektirmektedir.  Şimdi yeniden başlatmak ister misiniz?"
"[english]GameUI_OptionsRestartRequired_Info"	"The changes you have made require the game to be\nrestarted.  Do you wish to restart now?"
"GameUI_OptionsRestart_OKButton"	"Yeniden başlat"
"[english]GameUI_OptionsRestart_OKButton"	"Restart now"
"GameUI_OptionsRestart_CancelButton"	"Daha sonra yeniden başlat"
"[english]GameUI_OptionsRestart_CancelButton"	"Restart later"
"GameUI_VideoAdvanced_Title"	"GÖRÜNTÜ - GELİŞMİŞ"
"[english]GameUI_VideoAdvanced_Title"	"VIDEO - ADVANCED"
"GameUI_HudQuickInfo"	"Hızlı bilgi"
"[english]GameUI_HudQuickInfo"	"Quick info"
"GameUI_HudQuickInfo_Info"	"Sağlık ve cephane bilgilerini nişangâhta göster"
"[english]GameUI_HudQuickInfo_Info"	"Show health and ammo info on crosshair"
"GameUI_NoBonusMapsToDisplay"	"Bu klasörde bonus harita bulunmamaktadır."
"[english]GameUI_NoBonusMapsToDisplay"	"There are no bonus maps in this directory."
"GameUI_NoSaveGamesToDisplay"	"Gösterilecek oyun kaydı bulunmamaktadır."
"[english]GameUI_NoSaveGamesToDisplay"	"There are currently no save games to display."
"GameUI_SaveGame_CorruptFile"	"Bu oyun kaydı dosyaları zarar görmüş veya bozuk,\nyükleme yapılamıyor."
"[english]GameUI_SaveGame_CorruptFile"	"These saved game files have been damaged or corrupted,\nand cannot be loaded."
"GameUI_EasyDescription"	"Düşmanları yenmek kolaydır ve bilgisayar nişan alma konusunda size yardımcı olur."
"[english]GameUI_EasyDescription"	"Enemies are easy to defeat, and the computer helps you aim."
"GameUI_NormalDescription"	"Düşmanlar kolay kolay yenilmez; silahlarınız normal hasar verirler."
"[english]GameUI_NormalDescription"	"Challenging enemies; your weapons do normal damage."
"GameUI_HardDescription"	"Düşmanları yenmek çok zordur; silahlarınızın etkisi daha düşüktür."
"[english]GameUI_HardDescription"	"Enemies are very tough; your weapons are less effective."
"GameUI_CloseCaptions_Checkbox"	"Ekran yazıları"
"[english]GameUI_CloseCaptions_Checkbox"	"Display captions"
"GameUI_TestSpeakerSettings"	"Hoparlör ayarlarını sına"
"[english]GameUI_TestSpeakerSettings"	"Test speaker settings"
"GameUI_TestSpeakerSettingsWarning"	"Hoparlör ayarlarını sınamak, mevcut oyundan çıkmanıza neden olacaktır"
"[english]GameUI_TestSpeakerSettingsWarning"	"Testing speaker settings will disconnect you from the current game"
"GameUI_Enabled"	"Etkin"
"[english]GameUI_Enabled"	"Enabled"
"GameUI_Disabled"	"Devre Dışı"
"[english]GameUI_Disabled"	"Disabled"
"gameui_noreflections"	"Basit yansımalar"
"[english]gameui_noreflections"	"Simple reflections"
"gameui_reflectonlyworld"	"Mekan yansıması"
"[english]gameui_reflectonlyworld"	"Reflect world"
"gameui_reflectall"	"Tüm yansımalar"
"[english]gameui_reflectall"	"Reflect all"
"GameUI_ReportBug"	"HATA BİLDİR"
"[english]GameUI_ReportBug"	"REPORT BUG"
"GameUI_Bug_Successful"	"Hata başarıyla bildirildi!"
"[english]GameUI_Bug_Successful"	"Bug successfully submitted!"
"GameUI_Bug_Submitting"	"Hata bildiriliyor..."
"[english]GameUI_Bug_Submitting"	"Submitting Bug..."
"GameUI_Bug_TakeScreenshot"	"Ekran görüntüsü al"
"[english]GameUI_Bug_TakeScreenshot"	"Take screenshot"
"GameUI_Bug_AttachSavedGame"	"Oyun kaydı ekle"
"[english]GameUI_Bug_AttachSavedGame"	"Attach saved game"
"GameUI_Bug_ClearForm"	"Formu Temizle"
"[english]GameUI_Bug_ClearForm"	"Clear Form"
"GameUI_Bug_Title"	"Başlık:"
"[english]GameUI_Bug_Title"	"Title:"
"GameUI_Bug_Description"	"Açıklama:"
"[english]GameUI_Bug_Description"	"Description:"
"GameUI_Bug_Position"	"Konum:"
"[english]GameUI_Bug_Position"	"Position:"
"GameUI_Bug_Map"	"Harita:"
"[english]GameUI_Bug_Map"	"Map:"
"GameUI_Bug_Orientation"	"Yönlendirme:"
"[english]GameUI_Bug_Orientation"	"Orientation:"
"GameUI_Bug_ReportType"	"Bildiri türü:"
"[english]GameUI_Bug_ReportType"	"Report type:"
"GameUI_Bug_EmailAddress"	"E-posta Adresi:"
"[english]GameUI_Bug_EmailAddress"	"Email Address:"
"GameUI_Bug_PrivacyPolicy"	"Valve'ın Gizlilik Politikası"
"[english]GameUI_Bug_PrivacyPolicy"	"Valve's Privacy Policy"
"GameUI_Bug_Optional"	"(isteğe bağlı)"
"[english]GameUI_Bug_Optional"	"(optional)"
"GameUI_Bug_AccountName"	"Hesap Adı:"
"[english]GameUI_Bug_AccountName"	"Account Name:"
"GameUI_Bug_EngineBuild"	"SOURCE MOTORU YAPISI:"
"[english]GameUI_Bug_EngineBuild"	"SOURCE ENGINE BUILD:"
"GameUI_Bug_Submit"	"Bildir"
"[english]GameUI_Bug_Submit"	"Submit"
"GameUI_Bug_ClearFiles"	"Dosyaları temizle"
"[english]GameUI_Bug_ClearFiles"	"Clear files"
"GameUI_Bug_BSP_File"	".bsp dosyası"
"[english]GameUI_Bug_BSP_File"	".bsp file"
"GameUI_Bug_VMF_File"	".vmf dosyası"
"[english]GameUI_Bug_VMF_File"	".vmf file"
"GameUI_Bug_Include_BSP"	"Dahil .bsp"
"[english]GameUI_Bug_Include_BSP"	"Include .bsp"
"GameUI_Bug_Include_VMF"	"Dahil .vmf"
"[english]GameUI_Bug_Include_VMF"	"Include .vmf"
"GameUI_Bug_IncludeFile"	"Dosyayı dahil et..."
"[english]GameUI_Bug_IncludeFile"	"Include file..."
"GameUI_DX_Level"	"DirectX Donanım sürümü:"
"[english]GameUI_DX_Level"	"Hardware DirectX level:"
"GameUI_DX_Installed"	"DirectX Yazılım sürümü:"
"[english]GameUI_DX_Installed"	"Software DirectX level:"
"GameUI_Model_Detail"	"Model detayı"
"[english]GameUI_Model_Detail"	"Model detail"
"GameUI_Texture_Detail"	"Doku detayı"
"[english]GameUI_Texture_Detail"	"Texture detail"
"GameUI_Antialiasing_Mode"	"Keskinliği Yumuşatma"
"[english]GameUI_Antialiasing_Mode"	"Antialiasing mode"
"GameUI_Filtering_Mode"	"Filtre modu"
"[english]GameUI_Filtering_Mode"	"Filtering mode"
"GameUI_Water_Detail"	"Su detayı"
"[english]GameUI_Water_Detail"	"Water detail"
"GameUI_Shadow_Detail"	"Gölge detayı"
"[english]GameUI_Shadow_Detail"	"Shadow detail"
"GameUI_Wait_For_VSync"	"Dikey eşitleme"
"[english]GameUI_Wait_For_VSync"	"Wait for vertical sync"
"GameUI_Shader_Detail"	"Shader detayı"
"[english]GameUI_Shader_Detail"	"Shader detail"
"GameUI_Color_Correction"	"Renk Düzeltme"
"[english]GameUI_Color_Correction"	"Color Correction"
"GameUI_NoOptionsYet"	"< henüz seçenek yok >"
"[english]GameUI_NoOptionsYet"	"< no options yet >"
"GameUI_None"	"Yok"
"[english]GameUI_None"	"None"
"GameUI_Bilinear"	"İki Doğrusal Süzme"
"[english]GameUI_Bilinear"	"Bilinear"
"GameUI_Trilinear"	"Üç Doğrusal Süzme"
"[english]GameUI_Trilinear"	"Trilinear"
"GameUI_Anisotropic2X"	"Eşyönsüz Süzme 2X"
"[english]GameUI_Anisotropic2X"	"Anisotropic 2X"
"GameUI_Anisotropic4X"	"Eşyönsüz Süzme 4X"
"[english]GameUI_Anisotropic4X"	"Anisotropic 4X"
"GameUI_Anisotropic8X"	"Eşyönsüz Süzme 8X"
"[english]GameUI_Anisotropic8X"	"Anisotropic 8X"
"GameUI_Anisotropic16X"	"Eşyönsüz Süzme 16X"
"[english]GameUI_Anisotropic16X"	"Anisotropic 16X"
"GameUI_2X"	"2x MSAA"
"[english]GameUI_2X"	"2x MSAA"
"GameUI_4X"	"4x MSAA"
"[english]GameUI_4X"	"4x MSAA"
"GameUI_6X"	"6x MSAA"
"[english]GameUI_6X"	"6x MSAA"
"GameUI_8X"	"8x MSAA"
"[english]GameUI_8X"	"8x MSAA"
"GameUI_8X_CSAA"	"8x CSAA"
"[english]GameUI_8X_CSAA"	"8x CSAA"
"GameUI_16X_CSAA"	"16x CSAA"
"[english]GameUI_16X_CSAA"	"16x CSAA"
"GameUI_16XQ_CSAA"	"16xQ CSAA"
"[english]GameUI_16XQ_CSAA"	"16xQ CSAA"
"GameUI_RecommendedSettings"	"* Sisteminiz için önerilen ayar"
"[english]GameUI_RecommendedSettings"	"* Setting recommended for your system"
"GameUI_Bloom"	"Mevcutsa 'bloom' efekti kullan"
"[english]GameUI_Bloom"	"Use 'bloom' effect when available"
"GameUI_HDR"	"Yüksek Dinamik Aralık"
"[english]GameUI_HDR"	"High Dynamic Range"
"GameUI_hdr_level0"	"Yok"
"[english]GameUI_hdr_level0"	"None"
"GameUI_hdr_level1"	"Bloom (mevcutsa)"
"[english]GameUI_hdr_level1"	"Bloom (if available)"
"GameUI_hdr_level2"	"Tam (mevcutsa)"
"[english]GameUI_hdr_level2"	"Full (if available)"
"GameUI_hdr_level3"	"Genişletilmiş (Mevcutsa)"
"[english]GameUI_hdr_level3"	"Expanded (if available)"
"GameUI_HDR_NoteAboutMaps"	"(HDR etkileri sadece HDR haritalarında görünür)"
"[english]GameUI_HDR_NoteAboutMaps"	"(HDR effects appear only in HDR maps)"
"GameUI_MotionBlur"	"Hareket İzi"
"[english]GameUI_MotionBlur"	"Motion Blur"
"GameUI_LaunchBenchmark"	"PERFORMANS TESTİ"
"[english]GameUI_LaunchBenchmark"	"VIDEO STRESS TEST"
"GameUI_LaunchBenchmarkVideoPanel"	"Performans testini başlat..."
"[english]GameUI_LaunchBenchmarkVideoPanel"	"Begin stress test..."
"GameUI_StartBenchmark"	"Performans testini başlat"
"[english]GameUI_StartBenchmark"	"Begin video stress test"
"GameUI_LaunchBenchmark_Title"	"EKRAN KARTI PERFORMANS TESTİ"
"[english]GameUI_LaunchBenchmark_Title"	"VIDEO HARDWARE STRESS TEST"
"GameUI_LaunchBenchmark_Info"	"Bu performans testi, sisteminizin Source motorunda elde ettiği ortalama kare hızınızı ölçecektir. Testin sonunda sonuçları Valve'a gönderebilirsiniz. \nDerlenmiş sonuçlar daha sonra bir web sayfasında yayınlanacaktır."
"[english]GameUI_LaunchBenchmark_Info"	"This stress test will measure your average framerate while rendering elements in the Source engine. At the end of the test you will be able to upload your results to Valve. \nLater, there will be a web page available with the compiled results."
"GameUI_BenchmarkResults_Title"	"TEST SONUÇLARI"
"[english]GameUI_BenchmarkResults_Title"	"TEST RESULTS"
"GameUI_BenchmarkResults_Info"	"Hız testi sonucunda oluşan ortalama kare hızınız %framerate% fps'dir. Verilerinizi yollamayı seçerseniz bu testi yaptığınız İşlemcinin türünü ve hızını, Belleğinizin miktarını ve ekran kartınızın donanım bilgilerini göndereceksiniz."
"[english]GameUI_BenchmarkResults_Info"	"Your average framerate during the stress test was %framerate% fps. By choosing to upload your data you will be sending information about the type and speed of your CPU, amount of RAM, and the video hardware this test was run on."
"GameUI_BenchmarkResults_UploadNow"	"Sonuçları Valve'a gönder"
"[english]GameUI_BenchmarkResults_UploadNow"	"Upload results to Valve"
"GameUI_AdjustGamma"	"Parlaklık seviyesini ayarla..."
"[english]GameUI_AdjustGamma"	"Adjust brightness levels..."
"GameUI_AdjustGamma_Title"	"PARLAKLIK SEVİYESİNİ AYARLA"
"[english]GameUI_AdjustGamma_Title"	"ADJUST BRIGHTNESS LEVELS"
"GameUI_DisplayTV"	"Televizyon"
"[english]GameUI_DisplayTV"	"Television"
"GameUI_DisplayMonitor"	"Bilgisayar Monitörü"
"[english]GameUI_DisplayMonitor"	"Computer Monitor"
"GameUI_TestSpeakersWarning_Title"	"Hoparlör Ayarlarını Sına"
"[english]GameUI_TestSpeakersWarning_Title"	"Test Speaker Settings"
"GameUI_TestSpeakersWarning_Info"	"Hoparlör ayarlarını sınamak, mevcut oyundan çıkmanıza neden olacaktır."
"[english]GameUI_TestSpeakersWarning_Info"	"Testing speaker settings will disconnect you from the current game."
"GameUI_TestSpeakersWarning_OkButton"	"Hoparlör Testini Çalıştır"
"[english]GameUI_TestSpeakersWarning_OkButton"	"Run Speaker Test"
"GameUI_TestSpeakersWarning_CancelButton"	"İptal"
"[english]GameUI_TestSpeakersWarning_CancelButton"	"Cancel"
"GameUI_GammaInfo"	"Kaydırıcıyı metnin üç satırı görünecek şekilde ayarla."
"[english]GameUI_GammaInfo"	"Adjust the slider until all three lines of text below are visible."
"GameUI_SaveAndQuitQuery_Info"	"Çıkmadan önce oyunu kaydetmek ister misiniz?"
"[english]GameUI_SaveAndQuitQuery_Info"	"Do you wish to save the current game before exiting?"
"GameUI_SaveAndQuit"	"Kaydet"
"[english]GameUI_SaveAndQuit"	"Save"
"GameUI_DontSaveAndQuit"	"Kaydetme"
"[english]GameUI_DontSaveAndQuit"	"Don't save"
"GameUI_Captioning"	"Alt yazı"
"[english]GameUI_Captioning"	"Captioning"
"GameUI_NoClosedCaptions"	"Alt yazı yok"
"[english]GameUI_NoClosedCaptions"	"No captions"
"GameUI_Subtitles"	"Yalnızca Konuşmalar"	[$WIN32]
"[english]GameUI_Subtitles"	"Subtitles (dialog only)"
"GameUI_Subtitles"	"Alt yazılar"	[$X360]
"[english]GameUI_Subtitles"	"Subtitles"
"GameUI_SubtitlesAndSoundEffects"	"Tüm Sesler"
"[english]GameUI_SubtitlesAndSoundEffects"	"Closed Captions"
"GameUI_Paused"	"DURAKLATILDI"
"[english]GameUI_Paused"	"PAUSED"
"GameUI_Spray_Import_Error_Title"	"Sprey Ekleme Hatası"
"[english]GameUI_Spray_Import_Error_Title"	"Spray Import Error"
"GameUI_Spray_Import_Error_Reading_Image"	"Kaynak görüntü okunurken hata oluştu. Görüntü dosyası bozulmuş veya hatalı biçimlendirilmiş olabilir"
"[english]GameUI_Spray_Import_Error_Reading_Image"	"Error reading source image. Image file is possibly corrupt or improperly formated"
"GameUI_Spray_Import_Image_Wrong_Size"	"Kaynak görüntü uygun boyutta değil. Piksel cinsinden geçerli yükseklik ve genişlik değerleri: 256, 128, 64, 32, 16, 8, 4, 2, ve 1."
"[english]GameUI_Spray_Import_Image_Wrong_Size"	"Source image is not the correct size.  Valid height and width values in pixels are 256, 128, 64, 32, 16, 8, 4, 2, and 1."
"GameUI_Spray_Import_Error_Memory"	"Dönüştürme için yeterli bellek ayrılamıyor. Görüntü dosyası bozuk olabilir."
"[english]GameUI_Spray_Import_Error_Memory"	"Unable to allocate enough memory for conversion. Image file possibly corrupt."
"GameUI_Spray_Import_Error_Image_File_Corrupt"	"Görüntü dosyası bozuk."
"[english]GameUI_Spray_Import_Error_Image_File_Corrupt"	"Image file is corrupt."
"GameUI_Spray_Import_Error_BMP_Format_Not_Supported"	"Bu dosyanın BMP biçimi desteklenmiyor. Desteklenen BMP biçimleri: 24 bit RGB ve 32-bit RGBA."
"[english]GameUI_Spray_Import_Error_BMP_Format_Not_Supported"	"This file's BMP format is not supported.  Supported BMP formats are 24-bit RGB and 32-bit RGBA."
"GameUI_Spray_Import_Error_TGA_Format_Not_Supported"	"Bu dosyanın TGA biçimi desteklenmiyor. Desteklenen TGA biçimleri: 24 bit RGB ve 32 bit RGBA."
"[english]GameUI_Spray_Import_Error_TGA_Format_Not_Supported"	"This file's TGA format is not supported.  Supported TGA formats are 24-bit RGB and 32-bit RGBA."
"GameUI_Spray_Import_Error_Writing_Temp_Output"	"Geçici dosya oluşturulurken bir hata meydana geldi."
"[english]GameUI_Spray_Import_Error_Writing_Temp_Output"	"Error creating temporary file."
"GameUI_Spray_Import_Error_Cant_Load_VTEX_DLL"	"vtex_dll.dll yüklenemiyor. En son güncellemeleri edinmek için Steam'i yeniden başlatmayı deneyin."
"[english]GameUI_Spray_Import_Error_Cant_Load_VTEX_DLL"	"Unable to load vtex_dll.dll.  Try restarting steam to get the latest updates."
"GameUI_Spray_Import_Error_Writing_Output"	"Sprey dosyasının çıktısı yazılamıyor. Mevcut kullanıcı gerekli yetkilere sahip olmayabilir."
"[english]GameUI_Spray_Import_Error_Writing_Output"	"Unable to write output spray file.  It's possible the current user doesn't have permission."
"GameUI_ImportSprayEllipsis"	"Sprey Ekle..."
"[english]GameUI_ImportSprayEllipsis"	"Import Spray..."
"GameUI_ImportSprayImage"	"Sprey Görseli Ekle"
"[english]GameUI_ImportSprayImage"	"Import Spray Image"
"GameUI_All_Images"	"Bütün Görüntü Biçimleri (*.jpg,*.bmp,*.tga,*.vtf)"
"[english]GameUI_All_Images"	"All Images (*.jpg,*.bmp,*.tga,*.vtf)"
"GameUI_JPEG_Images"	"JPEG Görüntü Biçimi (*.jpg)"
"[english]GameUI_JPEG_Images"	"JPEG Images (*.jpg)"
"GameUI_TGA_Images"	"Targa Görüntü Biçimi (*.tga)"
"[english]GameUI_TGA_Images"	"Targa Images (*.tga)"
"GameUI_BMP_Images"	"Bitmap Görüntü Biçimi (*.bmp)"
"[english]GameUI_BMP_Images"	"Bitmap Images (*.bmp)"
"GameUI_VTF_Images"	"VTF Görüntü Biçimi (*.vtf)"
"[english]GameUI_VTF_Images"	"VTF Images (*.vtf)"
"GameUI_ImportBonusMapsEllipsis"	"Bonus Haritaları İçeriğe Al..."
"[english]GameUI_ImportBonusMapsEllipsis"	"Import Bonus Maps..."
"GameUI_ImportBonusMaps"	"Bonus Haritaları İçeriğe Al"
"[english]GameUI_ImportBonusMaps"	"Import Bonus Maps"
"GameUI_BMZ_Files"	"Bonus Harita Zip Dosyası (*.bmz)"
"[english]GameUI_BMZ_Files"	"Bonus Map Zip Files (*.bmz)"
"GameUI_SettingRequiresDisconnect_Title"	"SEÇENEKLER - UYARI"
"[english]GameUI_SettingRequiresDisconnect_Title"	"OPTIONS - WARNING"
"GameUI_SettingRequiresDisconnect_Info"	"Bu ayarı değiştirmek sizi, mevcut oyundan çıkaracaktır."
"[english]GameUI_SettingRequiresDisconnect_Info"	"Changing this setting will disconnect you from the current game."
"GameUI_SettingChangeFromX360Dashboard_Title"	"SEÇENEKLER"
"[english]GameUI_SettingChangeFromX360Dashboard_Title"	"OPTIONS"
"GameUI_SettingChangeFromX360Dashboard_Info"	"Bu ayarlar yalnızca Xbox 360 Dashboard üzerinden değiştirilebilir."
"[english]GameUI_SettingChangeFromX360Dashboard_Info"	"This setting can only be changed from the Xbox 360 Dashboard."
"GameUI_Dlg_CheckingStorageDevice"	"Depolama aygıtı kontrol ediliyor..."
"[english]GameUI_Dlg_CheckingStorageDevice"	"Checking storage device..."
"GameUI_Chapter"	"BÖLÜM"
"[english]GameUI_Chapter"	"CHAPTER"
"VAC_LoggedInElsewhere_Title"	"Hesap Başka Yerde Kullanımda"
"[english]VAC_LoggedInElsewhere_Title"	"Account Used Elsewhere"
"VAC_LoggedInElsewhereReason"	"Bu Steam hesabının oturumu başka bilgisayarda açık durumda. Steam'i kullanmaya devam etmek için, tekrar giriş yapmalısınız."
"[english]VAC_LoggedInElsewhereReason"	"This Steam account has been used to log in from another computer. To continue using Steam, you need to log in again."
"GAMEUI_Commentary"	"Yorum"
"[english]GAMEUI_Commentary"	"Commentary"
"GAMEUI_Commentary_On"	"Açık (mevcutsa)"
"[english]GAMEUI_Commentary_On"	"On (where available)"
"GAMEUI_Commentary_Off"	"Kapalı"
"[english]GAMEUI_Commentary_Off"	"Off"
"GAMEUI_CommentaryDialogTitle"	"YORUM"
"[english]GAMEUI_CommentaryDialogTitle"	"COMMENTARY"
"GAMEUI_Commentary_LabelOn"	"YORUM MODU ŞU ANDA: AÇIK"
"[english]GAMEUI_Commentary_LabelOn"	"COMMENTARY MODE IS CURRENTLY: ON"
"GAMEUI_Commentary_LeaveOn"	"Yorum modunu AÇ"
"[english]GAMEUI_Commentary_LeaveOn"	"Leave commentary ON"
"GAMEUI_Commentary_TurnOff"	"Yorumu KAPAT"
"[english]GAMEUI_Commentary_TurnOff"	"Turn commentary OFF"
"GAMEUI_Commentary_LabelOff"	"YORUM KİPİ ŞU ANDA: KAPALI"
"[english]GAMEUI_Commentary_LabelOff"	"COMMENTARY MODE IS CURRENTLY: OFF"
"GAMEUI_Commentary_TurnOn"	"Yorumu AÇ"
"[english]GAMEUI_Commentary_TurnOn"	"Turn commentary ON"
"GAMEUI_Commentary_LeaveOff"	"Yorum modunu KAPAT"
"[english]GAMEUI_Commentary_LeaveOff"	"Leave commentary OFF"
"GAMEUI_PostCommentary_ModeLabelOn"	"YORUM MODU: AÇIK"
"[english]GAMEUI_PostCommentary_ModeLabelOn"	"COMMENTARY MODE IS: ON"
"GAMEUI_PostCommentary_ModeLabelOff"	"YORUM MODU: KAPALI"
"[english]GAMEUI_PostCommentary_ModeLabelOff"	"COMMENTARY MODE IS: OFF"
"GAMEUI_PostCommentary_options"	"(Yorumu açmak veya kapatmak için, ana menüdeki \"seçenekler\" bölümünü seçin.)"
"[english]GAMEUI_PostCommentary_options"	"(To turn commentary on or off, select \"options\" from the main menu.)"
"GAMEUI_LostCoastHasCommentary"	"Half-Life 2: Lost Coast, Valve geliştirme ekibinin sesli yorumlarını içermektedir."
"[english]GAMEUI_LostCoastHasCommentary"	"Half-Life 2: Lost Coast includes audio commentary, spoken by members of the Valve development team."
"GAMEUI_Commentary_WhatIs"	"Yorum modu, Valve geliştirme ekibinin sesli yorumlarını içeren bilgi baloncuklarına erişimi sağlamaktadır."
"[english]GAMEUI_Commentary_WhatIs"	"Commentary mode allows access to information nodes, containing audio commentary spoken by members of the Valve development team."
"GAMEUI_Commentary_HowToUse"	"Bir bilgi baloncuğunu başlatmak veya durdurmak için, baloncukların üzerine nişan alıp KULLAN tuşuna basın."
"[english]GAMEUI_Commentary_HowToUse"	"To start or stop a commentary node, aim your crosshairs at any balloon icon and then press your USE key."
"GAMEUI_Commentary_HowToUse_Attack"	"Bir yorumu başlatmak veya durdurmak için, konuşma balonu sembolünün üzerine nişan alıp BİRİNCİL SALDIRI tuşuna basın."
"[english]GAMEUI_Commentary_HowToUse_Attack"	"To start or stop a commentary node, aim your crosshairs at any balloon icon and then press your PRIMARY FIRE key."
"GAMEUI_COMMENTARY_GOD"	"(Oyunu yorum kipinde oynarken, oyun içinde yaralanmazsınız.)"
"[english]GAMEUI_COMMENTARY_GOD"	"(While playing the game in commentary mode, you will be invulnerable to damage and achievements will not be awarded.)"
"GAMEUI_Commentary_Console_Explanation"	"'Açıklama İşaretleri' Valve geliştirme takımından yorumlar içerir. Bir işareti başlatmak veya durdurmak için, balon simgesine nişan alın ve KULLAN tuşuna basın. (Bir açıklamayı dinlerken hasar almayacaksınız. Başarımlar açıklama modunda kapalıdır.)"
"[english]GAMEUI_Commentary_Console_Explanation"	"'Commentary nodes' contain audio commentary by the Valve development team. To start or stop a node, aim at any balloon icon and press your USE button. (You will be invulnerable to damage while listening to a node. Achievements can not be earned in commentary mode.)"
"GAMEUI_AudioSpokenLanguage"	"Seslendirme dili"
"[english]GAMEUI_AudioSpokenLanguage"	"Audio (spoken) language"
"GameUI_ThirdPartyTechCredits"	"3. parti teknoloji sağlayıcıları"
"[english]GameUI_ThirdPartyTechCredits"	"3rd party technology credits"
"GameUI_ThirdPartyAudio_Title"	"3. PARTİ SES TEKNOLOJİSİ"
"[english]GameUI_ThirdPartyAudio_Title"	"3rd PARTY AUDIO TECHNOLOGY"
"GameUI_ThirdPartyVideo_Title"	"3. PARTİ VIDEO TEKNOLOJİSİ"
"[english]GameUI_ThirdPartyVideo_Title"	"3rd PARTY VIDEO TECHNOLOGY"
"GAMEUI_RequiresRestart"	"(Yeniden başlatma gerekir)"
"[english]GAMEUI_RequiresRestart"	"(Requires restart)"
"GameUI_ChangeLanguageRestart_OkButton"	"Yeniden Başlat"
"[english]GameUI_ChangeLanguageRestart_OkButton"	"Restart Now"
"GameUI_ChangeLanguageRestart_CancelButton"	"İptal"
"[english]GameUI_ChangeLanguageRestart_CancelButton"	"Cancel"
"GameUI_ChangeLanguageRestart_Title"	"SESLENDİRME DİLİNİ DEĞİŞTİR"
"[english]GameUI_ChangeLanguageRestart_Title"	"CHANGE SPOKEN AUDIO LANGUAGE"
"GameUI_ChangeLanguageRestart_Info"	"Seslendirme dilini değiştirmek için bu oyunu yeniden başlatmalısınız.\n\nŞimdi yeniden başlatmak ister misiniz?"
"[english]GameUI_ChangeLanguageRestart_Info"	"The game must restart in order to change the spoken audio language.\n\nWould you like to restart now?"
"GameUI64_64BitNotice"	"64-bit kipi etkin"
"[english]GameUI64_64BitNotice"	"64-bit mode active"
"GameUI_LoadCommentary"	"GELİŞTİRİCİ YORUMLARI"
"[english]GameUI_LoadCommentary"	"DEVELOPER COMMENTARY"
"GameUI_LoadCommentaryHelp"	"Aşağıdaki listeden bir yorum parçası seçin, ve daha sonra 'Oyunu yükle' bölümüne tıklayın."
"[english]GameUI_LoadCommentaryHelp"	"Select a commentary track in the list below, then click 'Load game'."
"GameUI_NoCommentaryItemsToDisplay"	"Yorum parçası bulunmuyor."
"[english]GameUI_NoCommentaryItemsToDisplay"	"No commentary tracks available."
"GameUI_CommentaryUnlock"	"Yorumunu açmak için o bölümü tamamla."
"[english]GameUI_CommentaryUnlock"	"Complete a chapter to unlock its commentary."
"GameUI_A_BUTTON"	"A Tuşu"
"[english]GameUI_A_BUTTON"	"A Button"
"GameUI_B_BUTTON"	"B Tuşu"
"[english]GameUI_B_BUTTON"	"B Button"
"GameUI_X_BUTTON"	"X Tuşu"
"[english]GameUI_X_BUTTON"	"X Button"
"GameUI_Y_BUTTON"	"Y Tuşu"
"[english]GameUI_Y_BUTTON"	"Y Button"
"GameUI_L_TRIGGER"	"Sol Tetik"
"[english]GameUI_L_TRIGGER"	"Left Trigger"
"GameUI_R_TRIGGER"	"Sağ Tetik"
"[english]GameUI_R_TRIGGER"	"Right Trigger"
"GameUI_L_SHOULDER"	"Sol Omuz Tuşu"
"[english]GameUI_L_SHOULDER"	"Left Shoulder"
"GameUI_R_SHOULDER"	"Sağ Omuz Tuşu"
"[english]GameUI_R_SHOULDER"	"Right Shoulder"
"GameUI_Icons_UP"	"U"
"[english]GameUI_Icons_UP"	"U"
"GameUI_Icons_DOWN"	"D"
"[english]GameUI_Icons_DOWN"	"D"
"GameUI_Icons_LEFT"	"L"
"[english]GameUI_Icons_LEFT"	"L"
"GameUI_Icons_RIGHT"	"R"
"[english]GameUI_Icons_RIGHT"	"R"
"GameUI_Icons_DPAD"	"C"
"[english]GameUI_Icons_DPAD"	"C"
"GameUI_Icons_START"	"5"
"[english]GameUI_Icons_START"	"5"
"GameUI_Icons_STICK1"	"6"
"[english]GameUI_Icons_STICK1"	"6"
"GameUI_Icons_STICK2"	"7"
"[english]GameUI_Icons_STICK2"	"7"
"GameUI_Icons_S1_UP"	"6"
"[english]GameUI_Icons_S1_UP"	"6"
"GameUI_Icons_S2_UP"	"7"
"[english]GameUI_Icons_S2_UP"	"7"
"GameUI_Icons_LSTICK"	"6"
"[english]GameUI_Icons_LSTICK"	"6"
"GameUI_Icons_RSTICK"	"7"
"[english]GameUI_Icons_RSTICK"	"7"
"GameUI_Icons_A_BUTTON"	"A"
"[english]GameUI_Icons_A_BUTTON"	"A"
"GameUI_Icons_B_BUTTON"	"B"
"[english]GameUI_Icons_B_BUTTON"	"B"
"GameUI_Icons_X_BUTTON"	"X"
"[english]GameUI_Icons_X_BUTTON"	"X"
"GameUI_Icons_Y_BUTTON"	"Y"
"[english]GameUI_Icons_Y_BUTTON"	"Y"
"GameUI_Icons_L_SHOULDER"	"2"
"[english]GameUI_Icons_L_SHOULDER"	"2"
"GameUI_Icons_R_SHOULDER"	"3"
"[english]GameUI_Icons_R_SHOULDER"	"3"
"GameUI_Icons_L_TRIGGER"	"0"
"[english]GameUI_Icons_L_TRIGGER"	"0"
"GameUI_Icons_R_TRIGGER"	"1"
"[english]GameUI_Icons_R_TRIGGER"	"1"
"GameUI_Icons_LEFTCURSOR"	"8"
"[english]GameUI_Icons_LEFTCURSOR"	"8"
"GameUI_Icons_RIGHTCURSOR"	"9"
"[english]GameUI_Icons_RIGHTCURSOR"	"9"
"GameUI_Icons_UPCURSOR"	"<"
"[english]GameUI_Icons_UPCURSOR"	"<"
"GameUI_Icons_DOWNCURSOR"	">"
"[english]GameUI_Icons_DOWNCURSOR"	">"
"GameUI_Icons_NONE"	"< tuş atanmadı >"
"[english]GameUI_Icons_NONE"	"< not assigned >"
"GameUI_KeyNames_UP"	"D-pad yukarı"
"[english]GameUI_KeyNames_UP"	"D-pad up"
"GameUI_KeyNames_DOWN"	"D-pad aşağı"
"[english]GameUI_KeyNames_DOWN"	"D-pad down"
"GameUI_KeyNames_LEFT"	"D-pad sol"
"[english]GameUI_KeyNames_LEFT"	"D-pad left"
"GameUI_KeyNames_RIGHT"	"D-pad sağ"
"[english]GameUI_KeyNames_RIGHT"	"D-pad right"
"GameUI_KeyNames_START"	"START tuşu"
"[english]GameUI_KeyNames_START"	"START button"
"GameUI_KeyNames_BACK"	"GERİ tuşu"
"[english]GameUI_KeyNames_BACK"	"BACK button"
"GameUI_KeyNames_STICK1"	"LS"
"[english]GameUI_KeyNames_STICK1"	"left stick button"
"GameUI_KeyNames_STICK2"	"RS"
"[english]GameUI_KeyNames_STICK2"	"right stick button"
"GameUI_KeyNames_S1_UP"	"LS"
"[english]GameUI_KeyNames_S1_UP"	"left stick"
"GameUI_KeyNames_S2_UP"	"RS"
"[english]GameUI_KeyNames_S2_UP"	"right stick"
"GameUI_KeyNames_LSTICK"	"LS"
"[english]GameUI_KeyNames_LSTICK"	"left stick"
"GameUI_KeyNames_RSTICK"	"RS"
"[english]GameUI_KeyNames_RSTICK"	"right stick"
"GameUI_KeyNames_A_BUTTON"	"A tuşu"
"[english]GameUI_KeyNames_A_BUTTON"	"A button"
"GameUI_KeyNames_B_BUTTON"	"B tuşu"
"[english]GameUI_KeyNames_B_BUTTON"	"B button"
"GameUI_KeyNames_X_BUTTON"	"X tuşu"
"[english]GameUI_KeyNames_X_BUTTON"	"X button"
"GameUI_KeyNames_Y_BUTTON"	"Y tuşu"
"[english]GameUI_KeyNames_Y_BUTTON"	"Y button"
"GameUI_KeyNames_L_SHOULDER"	"LB"
"[english]GameUI_KeyNames_L_SHOULDER"	"left bumper"
"GameUI_KeyNames_R_SHOULDER"	"RB"
"[english]GameUI_KeyNames_R_SHOULDER"	"right bumper"
"GameUI_KeyNames_L_TRIGGER"	"LT"
"[english]GameUI_KeyNames_L_TRIGGER"	"left trigger"
"GameUI_KeyNames_R_TRIGGER"	"RT"
"[english]GameUI_KeyNames_R_TRIGGER"	"right trigger"
"GameUI_Game"	"OYUN"	[$X360]
"[english]GameUI_Game"	"GAME"
"GameUI_Controller"	"OYUN KUMANDASI"
"[english]GameUI_Controller"	"CONTROLLER"
"GameUI_Buttons"	"TUŞLAR"
"[english]GameUI_Buttons"	"BUTTONS"
"GameUI_RestoreDefaults"	"VARSAYILANA GERİ DÖN"
"[english]GameUI_RestoreDefaults"	"RESTORE DEFAULTS"
"GameUI_Accept"	"Kabul"
"[english]GameUI_Accept"	"Accept"
"GameUI_Select"	"Seç"
"[english]GameUI_Select"	"Select"
"GameUI_Refresh"	"Yenile"
"[english]GameUI_Refresh"	"Refresh"
"GameUI_Sort"	"Sıralama"
"[english]GameUI_Sort"	"Sort"
"GameUI_ExitLobby"	"Çıkış"
"[english]GameUI_ExitLobby"	"Exit"
"GameUI_ChangeTeam"	"Takım Değiştir"
"[english]GameUI_ChangeTeam"	"Change Team"
"GameUI_ChangeGameSettings"	"Ayarları Değiştir"
"[english]GameUI_ChangeGameSettings"	"Change Settings"
"GameUI_PlayerReview"	"Oyuncu İncelemesi"
"[english]GameUI_PlayerReview"	"Player Review"
"GameUI_StartGame"	"Oyunu Başlat"
"[english]GameUI_StartGame"	"Start Game"
"GameUI_StopCountdown"	"Geri Sayımı İptal Et"
"[english]GameUI_StopCountdown"	"Cancel Countdown"
"GameUI_Console_FileCorrupt"	"Seçilen depolama aygıtı bozuk veya açılamaz bir dosya içeriyor. Lütfen başka bir depolama aygıtı seçin veya bozuk dosyayı silin."
"[english]GameUI_Console_FileCorrupt"	"The selected storage device contains a file that is corrupted or not able to be opened.  Please choose another storage device or delete the corrupted file."
"GameUI_AppChooser_SelectGame"	"OYUN SEÇ:"
"[english]GameUI_AppChooser_SelectGame"	"SELECT GAME:"
"GameUI_Yes"	"Evet"
"[english]GameUI_Yes"	"Yes"
"GameUI_No"	"Hayır"
"[english]GameUI_No"	"No"
"GameUI_Console_QuitWarning"	"Çıkış yapmak istediğinize emin misiniz?\nKaydedilmemiş verilerin tümü kaybedilecek."
"[english]GameUI_Console_QuitWarning"	"Are you sure you want to quit?\nAll unsaved progress will be lost."
"GameUI_Console_StorageRemovedTitle"	"Depolama Aygıtı Kaldırıldı"
"[english]GameUI_Console_StorageRemovedTitle"	"Storage Device Removed"
"GameUI_Console_StorageRemovedBody"	"Depolama aygıtı olmadan ilerlemenizi kaydedemezsiniz. Başka bir depolama aygıtı seçmek ister misiniz?"
"[english]GameUI_Console_StorageRemovedBody"	"You will not be able to save your progress without a storage device. Would you like to select another storage device?"
"GameUI_Console_StorageNeededBody"	"Depolama aygıtı olmadan oynamaya devam edemezsiniz. Başka bir depolama aygıtı seçmek ister misiniz?"
"[english]GameUI_Console_StorageNeededBody"	"You will not be able to continue playing without a storage device. Would you like to select another storage device?"
"GameUI_Console_StorageChange"	"Depolama Aygıtını Değiştir"
"[english]GameUI_Console_StorageChange"	"Change Storage Device"
"GameUI_Console_StorageTooFullTitle"	"Depolama Aygıtı Dolu"
"[english]GameUI_Console_StorageTooFullTitle"	"Storage Device Full"
"GameUI_Console_StorageTooFullBody"	"Seçilen depolama aygıtı oyun kaydı oluşturmak için yeterli alana sahip değil. Başka bir depolama aygıtı seçmek ister misiniz?"
"[english]GameUI_Console_StorageTooFullBody"	"The selected storage device does not have enough space to create new saved games. Would you like to select another storage device?"
"GameUI_Console_NoStorageDeviceSelectedTitle"	"Depolama Aygıtı Seçilmedi"
"[english]GameUI_Console_NoStorageDeviceSelectedTitle"	"No Storage Device Selected"
"GameUI_Console_NoStorageDeviceSelectedBody"	"Depolama aygıtı seçmek ister misiniz?\n\n'Hayır' seçeneği oyunu oynamanıza izin verir ancak ilerlemenizi kayıt edemezsiniz."
"[english]GameUI_Console_NoStorageDeviceSelectedBody"	"Would you like to select a storage device?\n\nChoosing 'No' will let you play the game, but you will not be able to save your progress."
"GameUI_Console_NoUserProfileSelectedTitle"	"Oyuncu Profili Seçilmedi"
"[english]GameUI_Console_NoUserProfileSelectedTitle"	"No Gamer Profile Selected"
"GameUI_Console_NoUserProfileSelectedBody"	"Bir oyuncu profili seçmek ister misiniz?\n'Hayır' seçimi oyunu oynamanıza izin verir fakat ilerlemenizi kaydedemezsiniz."
"[english]GameUI_Console_NoUserProfileSelectedBody"	"Would you like to select a gamer profile?\nChoosing 'No' will let you play the game, but you will not be able to save your progress."
"GameUI_Console_UserProfileRequiredBody"	"Bu eylem için önce giriş yapmanız gereklidir.\nBir oyuncu profili seçmek ister misiniz?"
"[english]GameUI_Console_UserProfileRequiredBody"	"This action requires that you be signed in.\nWould you like to select a gamer profile?"
"GameUI_Console_StorageDeviceRequiredBody"	"Bu eylem için depolama aygıtı seçmeniz gerekir.\n\nDepolama aygıtı seçmek ister misiniz?"
"[english]GameUI_Console_StorageDeviceRequiredBody"	"This action requires that you select a storage device.\n\nWould you like to select a storage device?"
"GameUI_Achievement_Awarded"	"Başarım Kazanıldı"
"[english]GameUI_Achievement_Awarded"	"Achievement Unlocked"
"GameUI_Achievement_Progress"	"Başarım İlerlemesi"
"[english]GameUI_Achievement_Progress"	"Achievement Progress"
"GameUI_Achievement_Progress_Fmt"	"%s1 (%s2/%s3)"
"[english]GameUI_Achievement_Progress_Fmt"	"%s1 (%s2/%s3)"
"GameUI_Achievement_Locked"	"Kazanılmayan"
"[english]GameUI_Achievement_Locked"	"Locked"
"GameUI_Achievement_Unlocked"	"Kazanılan"
"[english]GameUI_Achievement_Unlocked"	"Unlocked"
"GameUI_Achievements_Title"	"Başarımlarım"
"[english]GameUI_Achievements_Title"	"My Achievements"
"GameUI_Achievements_SteamRequired_Title"	"Steam Girişi Gerekli"
"[english]GameUI_Achievements_SteamRequired_Title"	"Steam Login Required"
"GameUI_Achievements_SteamRequired_Message"	"Başarımları kazanmak veya görüntülemek için Steam'e giriş yapmalısınız."
"[english]GameUI_Achievements_SteamRequired_Message"	"You must be logged in to Steam to unlock or view Achievements."
"GameUI_Achievements_EnterGameToSeeProgress"	"İlerlemeyi görmek için oyuna girin"
"[english]GameUI_Achievements_EnterGameToSeeProgress"	"Enter game to see progress"
"GameUI_Achievement_Points"	"%s1G"
"[english]GameUI_Achievement_Points"	"%s1G"
"GameUI_Achievement_Menu_Range"	"%s1 / %s2"
"[english]GameUI_Achievement_Menu_Range"	"%s1 of %s2"
"GameUI_Achievements_Earned"	"Kazanılan Toplam Başarımlar"
"[english]GameUI_Achievements_Earned"	"Total Achievements Earned"
"GameUI_Achievement_Hide_Achieved"	"Kazanılanları Gizle"
"[english]GameUI_Achievement_Hide_Achieved"	"Hide Achieved"
"GameUI_Achievement_Hide_Unachieved"	"Kazanılmayanları Gizle"
"[english]GameUI_Achievement_Hide_Unachieved"	"Hide Unachieved"
"GameUI_Achievement_Show_HUD"	"Ekranda Göster"
"[english]GameUI_Achievement_Show_HUD"	"Show on HUD"
"GameUI_Console_UserSettings"	"Kullanıcı Ayarları"
"[english]GameUI_Console_UserSettings"	"User Settings"
"GameUI_Console_Ep1_Saves"	"HL2: Episode One Kayıtları"
"[english]GameUI_Console_Ep1_Saves"	"HL2: Episode One Saves"
"GameUI_Console_Ep2_Saves"	"HL2: Episode Two Kayıtları"
"[english]GameUI_Console_Ep2_Saves"	"HL2: Episode Two Saves"
"GameUI_Console_Portal_Saves"	"Portal Kayıtları"
"[english]GameUI_Console_Portal_Saves"	"Portal Saves"
"GameUI_Console_TF2_Saves"	"Team Fortress 2 Kayıtları"
"[english]GameUI_Console_TF2_Saves"	"Team Fortress 2 Saves"
"GameUI_Console_HL2_Saves"	"Half-Life 2 Kayıtları"
"[english]GameUI_Console_HL2_Saves"	"Half-Life 2 Saves"
"GameUI_LoadFailed"	"Yükleme Başarısız"
"[english]GameUI_LoadFailed"	"Load Failed"
"GameUI_LoadFailed_Description"	"Depolama aygıtı yüklenirken kaldırılmış veya dosya bozuk.\n\nOyun kaydı yüklenemiyor."
"[english]GameUI_LoadFailed_Description"	"A storage device was removed while loading, or a file was corrupt.\n\nUnable to load save game."
"HLX_KILL_ENEMIES_WITHPHYSICS_NAME"	"Kemik Kırıcı"
"[english]HLX_KILL_ENEMIES_WITHPHYSICS_NAME"	"Bone Breaker"
"HLX_KILL_ENEMIES_WITHPHYSICS_DESC"	"30 düşmanı fizik nesneleri fırlatarak öldür."
"[english]HLX_KILL_ENEMIES_WITHPHYSICS_DESC"	"Kill 30 enemies with thrown physics objects."
"HLX_KILL_ENEMY_WITHHOPPERMINE_NAME"	"Ölümcül Hasat"
"[english]HLX_KILL_ENEMY_WITHHOPPERMINE_NAME"	"Deadly Harvest"
"HLX_KILL_ENEMY_WITHHOPPERMINE_DESC"	"Zıpzıp mayın ile bir düşman öldür."
"[english]HLX_KILL_ENEMY_WITHHOPPERMINE_DESC"	"Kill an enemy by planting a hopper mine."
"HLX_KILL_ENEMIES_WITHMANHACK_NAME"	"Kesici Saldırı!"
"[english]HLX_KILL_ENEMIES_WITHMANHACK_NAME"	"Hack Attack!"
"HLX_KILL_ENEMIES_WITHMANHACK_DESC"	"Sivilkeser ile beş düşman öldür."
"[english]HLX_KILL_ENEMIES_WITHMANHACK_DESC"	"Kill five enemies with a Manhack."
"HLX_KILL_SOLDIER_WITHHISGRENADE_NAME"	"Sahibe Geri Dönüş"
"[english]HLX_KILL_SOLDIER_WITHHISGRENADE_NAME"	"Hot Potat0wned"
"HLX_KILL_SOLDIER_WITHHISGRENADE_DESC"	"Combine askerini kendi el bombasıyla öldür."
"[english]HLX_KILL_SOLDIER_WITHHISGRENADE_DESC"	"Kill a Combine soldier with his own grenade."
"HLX_KILL_ENEMIES_WITHONEENERGYBALL_NAME"	"Doğa Dostu"
"[english]HLX_KILL_ENEMIES_WITHONEENERGYBALL_NAME"	"Conservationist"
"HLX_KILL_ENEMIES_WITHONEENERGYBALL_DESC"	"Beş düşmanı aynı enerji topuyla öldür."
"[english]HLX_KILL_ENEMIES_WITHONEENERGYBALL_DESC"	"Kill five enemies with the same energy ball."
"HLX_KILL_ELITESOLDIER_WITHHISENERGYBALL_NAME"	"Hızlı Düşün!"
"[english]HLX_KILL_ELITESOLDIER_WITHHISENERGYBALL_NAME"	"Think Fast!"
"HLX_KILL_ELITESOLDIER_WITHHISENERGYBALL_DESC"	"Özel Birlik Askerini kendi enerji topuyla öldür."
"[english]HLX_KILL_ELITESOLDIER_WITHHISENERGYBALL_DESC"	"Kill an Elite Soldier with his own energy ball."
"EPX_GET_ZOMBINEGRENADE_NAME"	"Mezar Soyguncusu"
"[english]EPX_GET_ZOMBINEGRENADE_NAME"	"Grave Robber"
"EPX_GET_ZOMBINEGRENADE_DESC"	"Bir Zombine'ın el bombasını çal."
"[english]EPX_GET_ZOMBINEGRENADE_DESC"	"Steal a Zombine's grenade."
"EPX_KILL_ZOMBIES_WITHFLARES_NAME"	"Zombikü"
"[english]EPX_KILL_ZOMBIES_WITHFLARES_NAME"	"Zombie-que"
"EPX_KILL_ZOMBIES_WITHFLARES_DESC"	"İşaret fişeklerini kullanarak 15 zombiyi yak."
"[english]EPX_KILL_ZOMBIES_WITHFLARES_DESC"	"Use flares to light 15 zombies on fire."
"GameUI_Language_English"	"İngilizce"
"[english]GameUI_Language_English"	"English"
"GameUI_Language_German"	"Almanca"
"[english]GameUI_Language_German"	"German"
"GameUI_Language_French"	"Fransızca"
"[english]GameUI_Language_French"	"French"
"GameUI_Language_Italian"	"İtalyanca"
"[english]GameUI_Language_Italian"	"Italian"
"GameUI_Language_Korean"	"Korece"
"[english]GameUI_Language_Korean"	"Korean"
"GameUI_Language_Spanish"	"İspanyolca"
"[english]GameUI_Language_Spanish"	"Spanish"
"GameUI_Language_Simplified_Chinese"	"Basitleştirilmiş_Çince"
"[english]GameUI_Language_Simplified_Chinese"	"Simplified_Chinese"
"GameUI_Language_Traditional_Chinese"	"Geleneksel_Çince"
"[english]GameUI_Language_Traditional_Chinese"	"Traditional_Chinese"
"GameUI_Language_Russian"	"Rusça"
"[english]GameUI_Language_Russian"	"Russian"
"GameUI_Language_Thai"	"Tayca"
"[english]GameUI_Language_Thai"	"Thai"
"GameUI_Language_Japanese"	"Japonca"
"[english]GameUI_Language_Japanese"	"Japanese"
"GameUI_Language_Portuguese"	"Portekizce"
"[english]GameUI_Language_Portuguese"	"Portuguese"
"GameUI_Language_Polish"	"Lehçe"
"[english]GameUI_Language_Polish"	"Polish"
"GameUI_Language_Danish"	"Danca"
"[english]GameUI_Language_Danish"	"Danish"
"GameUI_Language_Dutch"	"Flemenkçe"
"[english]GameUI_Language_Dutch"	"Dutch"
"GameUI_Language_Finnish"	"Fince"
"[english]GameUI_Language_Finnish"	"Finnish"
"GameUI_Language_Norwegian"	"Norveççe"
"[english]GameUI_Language_Norwegian"	"Norwegian"
"GameUI_Language_Swedish"	"İsveççe"
"[english]GameUI_Language_Swedish"	"Swedish"
"GameUI_LoadDialog_Hr_Min"	"%s1 saat %s2 dakika"
"[english]GameUI_LoadDialog_Hr_Min"	"%s1 hr %s2 min"
"GameUI_LoadDialog_Min_Sec"	"%s1 dakika %s2 saniye"
"[english]GameUI_LoadDialog_Min_Sec"	"%s1 min %s2 sec"
"GameUI_LoadDialog_Sec"	"%s1 saniye"
"[english]GameUI_LoadDialog_Sec"	"%s1 seconds"
"GameUI_DisableSprays"	"SPREYLERİ DEVRE DIŞI BIRAK."
"[english]GameUI_DisableSprays"	"Disable Sprays"
"GameUI_FOV"	"Görüş alanı"
"[english]GameUI_FOV"	"Field of view"
"GameUI_EnableHUDMinMode"	"BASİT GÖSTERGE"
"[english]GameUI_EnableHUDMinMode"	"Enable Minimal HUD"
"GameUI_DownloadFilter_Title"	"Oyun sunucusu bilgisayarınıza\nözel içerik indirmeyi denediğinde"
"[english]GameUI_DownloadFilter_Title"	"When a game server tries to download\ncustom content to your computer"
"GameUI_DownloadFilter_ALL"	"Sunucudaki özel dosyaları indir"
"[english]GameUI_DownloadFilter_ALL"	"Allow all custom files from server"
"GameUI_DownloadFilter_NoSounds"	"Özel sesleri indirme"
"[english]GameUI_DownloadFilter_NoSounds"	"Do not download custom sounds"
"GameUI_DownloadFilter_None"	"Özel dosyaların hiçbirini indirme"
"[english]GameUI_DownloadFilter_None"	"Do not download any custom files"
"GameUI_GameMenu_CharacterSetup"	"KARAKTER BİLGİSİ VE KURULUMU"
"[english]GameUI_GameMenu_CharacterSetup"	"CHARACTER INFO AND SETUP"
"GameUI_CustomTab_Title"	"Özel Sunucular"
"[english]GameUI_CustomTab_Title"	"Custom Servers"
"GameUI_CustomTab_Explanation"	"Sunucu tarayıcı pencerenin üst kısmında 'Özel' adında yeni bir sekmeye sahip"
"[english]GameUI_CustomTab_Explanation"	"The server browser has a new tab at the top of the window called 'Custom'"
"GameUI_CustomTab_Explanation2"	"Bu sunucular topluluk üyeleri tarafından varsayılan oyun deneyimini değiştirmek için modifiye edilmiştir. %game% oyununun modifiye edilmiş sürümünü oynamak istiyorsanız özel sekmesine tıklamayı deneyin."
"[english]GameUI_CustomTab_Explanation2"	"Servers listed there have been modified by members of the community to change the default game experience. Try clicking the custom tab if you want to play modified versions of %game%."
"GameUI_CustomTab_Explanation3"	"Özel sunucular hakkında daha fazla bilgi için izleyen bağlantıya tıklayabilirsiniz (bağlantı varsayılan web tarayıcınızda açılacaktır)"
"[english]GameUI_CustomTab_Explanation3"	"You can click the following link to read more about custom servers (link will open your default web browser)"
"GameUI_CustomTab_Link"	"Özel sunucular hakkında daha fazla bilgi"
"[english]GameUI_CustomTab_Link"	"More information about custom servers"
"GameUI_MulticoreRendering"	"Çoklu CPU Kullanımı"
"[english]GameUI_MulticoreRendering"	"Multicore Rendering"
"GameUI_Haptics_TabTitle"	"Falcon"
"[english]GameUI_Haptics_TabTitle"	"Falcon"
"GameUI_Haptics_Low"	"Düşük"
"[english]GameUI_Haptics_Low"	"Low"
"GameUI_Haptics_High"	"Yüksek"
"[english]GameUI_Haptics_High"	"High"
"GameUI_Haptics_ForceMasterScale"	"Ana Ölçek Gücü"
"[english]GameUI_Haptics_ForceMasterScale"	"Force Master Scale"
"GameUI_Haptics_RecoilScale"	"Geri Tepme Gücü"
"[english]GameUI_Haptics_RecoilScale"	"Recoil Forces"
"GameUI_Haptics_DamageScale"	"Hasar Gücü"
"[english]GameUI_Haptics_DamageScale"	"Damage Forces"
"GameUI_Haptics_MovementScale"	"Çevre Gücü"
"[english]GameUI_Haptics_MovementScale"	"Environment Forces"
"GameUI_Haptics_PlayerBoxScale"	"Oyuncu Kutusu Ölçeği"
"[english]GameUI_Haptics_PlayerBoxScale"	"Player Box Scale"
"GameUI_Haptics_PlayerBoxLabel"	"Oyuncu Kontrolü"
"[english]GameUI_Haptics_PlayerBoxLabel"	"Player Control"
"GameUI_Haptics_PlayerBoxStiffness"	"Sertlik"
"[english]GameUI_Haptics_PlayerBoxStiffness"	"Stiffness"
"GameUI_Haptics_Scale"	"Ölçek"
"[english]GameUI_Haptics_Scale"	"Scale"
"GameUI_Haptics_VehicleBoxLabel"	"Araç Kontrolü"
"[english]GameUI_Haptics_VehicleBoxLabel"	"Vehicle Control"
"GameUI_Haptics_VehicleBoxStiffness"	"Sertlik"
"[english]GameUI_Haptics_VehicleBoxStiffness"	"Stiffness"
"GameUI_Haptics_Turning"	"Dönüş Hassasiyeti"
"[english]GameUI_Haptics_Turning"	"Turn Sensitivity"
"GameUI_Haptics_Aiming"	"Hedefleme Hassasiyeti"
"[english]GameUI_Haptics_Aiming"	"Aim Sensitivity"
"GameUI_NoSteamStatsTracking"	"İstatistiklerinizin izlenebilmesi için Steam'e bağlantı gereklidir.\nBağlantı sağlanıldığında size bildirilecek."
"[english]GameUI_NoSteamStatsTracking"	"A connection to Steam is required in order to track your statistics.\nOnce a connection has been established you will be notified."
"GameUI_SteamStatsNowTracking"	"Steam ile bağlantı sağlandı ve istatistikleriniz artık izlenebilecek."
"[english]GameUI_SteamStatsNowTracking"	"A connection to Steam has been established and your statistics will now be tracked."
"GameUI_GameMenu_MainMenu"	"ANA MENÜ"
"[english]GameUI_GameMenu_MainMenu"	"MAIN MENU"
"GameUI_GameMenu_Training"	"EĞİTİM"
"[english]GameUI_GameMenu_Training"	"TUTORIAL"
"GameUI_GameMenu_OfflinePractice"	"ÇEVRİMDIŞI ALIŞTIRMA"
"[english]GameUI_GameMenu_OfflinePractice"	"OFFLINE PRACTICE"
"GameUI_ResetStats"	"İstatistikleri Sıfırla"
"[english]GameUI_ResetStats"	"Reset All Stats"
"GameUI_ConfirmResetStatsTitle"	"İstatistikleri Sıfırla"
"[english]GameUI_ConfirmResetStatsTitle"	"Reset All Stats"
"GameUI_ConfirmResetStatsText"	"İstatistiklerin tümünü sıfırlamak istediğinize emin misiniz? Eski başarımlarınız korunur ancak kazanmaya çalıştığınız başarımlarınızın ilerlemelerini kaybedersiniz."
"[english]GameUI_ConfirmResetStatsText"	"Are you sure you want to reset all stats?  You will keep existing achievements, but progress towards future achievements will be lost."
"GameUI_Reset"	"İstatistikleri Sıfırla"
"[english]GameUI_Reset"	"Reset All Stats"
"GameUI_GameMenu_Store"	"EŞYA ALIŞVERİŞİ"
"[english]GameUI_GameMenu_Store"	"SHOP FOR ITEMS"
"GameUI_SndMuteLoseFocus"	"Oyunun penceresi arka plandayken sesini kapat."
"[english]GameUI_SndMuteLoseFocus"	"Silence the audio while the game window is in the background."
"GameUI_CloseBrowserOnConnect"	"SUNUCUYA BAĞLANDIKTAN SONRA SUNUCU TARAYICISINI KAPAT."
"[english]GameUI_CloseBrowserOnConnect"	"Close the server browser after connecting to a server."
"GameUI_MouseRaw"	"Raw girişi"
"[english]GameUI_MouseRaw"	"Raw input"
"GameUI_MouseRaw_Hint"	"Raw girişi fare hareketlerini direkt olarak aygıttan okur. Kontrol panelindeki fare ayarlarına geçin ve daha güvenilir bir fare hareketi sağlayın."
"[english]GameUI_MouseRaw_Hint"	"Raw input reads mouse movement directly from the device, bypassing control panel mouse settings, and providing more reliable mouse movement."
"GameUI_MouseAcceleration"	"Fare ivmesi"
"[english]GameUI_MouseAcceleration"	"Mouse acceleration"
"GameUI_MouseAcceleration_Hint"	"Fare ivmesini etkinleştir (raw girişi kullanıldığında önerilir)"
"[english]GameUI_MouseAcceleration_Hint"	"Enable mouse acceleration (recommended when using raw input)"
"GameUI_MouseAccelerationAmount_Hint"	"İvme miktarı. 1.0 değeri hızlandırılmamış olup; yüksek değerler buna hız eklenmesini sağlayacaktır."
"[english]GameUI_MouseAccelerationAmount_Hint"	"Amount of acceleration. A value of 1.0 is unaccelerated; higher values will provide additional acceleration."
"GameUI_ServerConnectOutOfDate"	"Sunucu en yeni sürümüne güncellenmemiş.\n"
"[english]GameUI_ServerConnectOutOfDate"	"Server has not updated to the most recent version.\n"
"GameUI_ServerChallengeIncorrect"	"Sunucu geçerli bir kimlikle yanıt vermiyor.\nGüncel olmayabilir.\n"
"[english]GameUI_ServerChallengeIncorrect"	"Server did not respond with the correct challenge.\nIt may be out of date.\n"
"GameUI_ServerInsecure"	"Şu anda güvensiz moddasınız. Güvenli sunuculara bağlanmak için yeniden başlatmalısınız.\n"
"[english]GameUI_ServerInsecure"	"You are in insecure mode.  You must restart before you can connect to secure servers.\n"
"GameUI_ServerRejectBadChallenge"	"Bozuk kimlik.\n"
"[english]GameUI_ServerRejectBadChallenge"	"Bad challenge.\n"
"GameUI_ServerRejectLANRestrict"	"Yerel Ağ sunucuları yerel istemcilerle sınırlıdır (C sınıfı).\n"
"[english]GameUI_ServerRejectLANRestrict"	"LAN servers are restricted to local clients (class C).\n"
"GameUI_ServerRejectBadPassword"	"Yanlış parola.\n"
"[english]GameUI_ServerRejectBadPassword"	"Bad password.\n"
"GameUI_ServerRejectServerFull"	"Sunucu dolu.\n"
"[english]GameUI_ServerRejectServerFull"	"Server is full.\n"
"GameUI_ServerRejectBanned"	"Bu sunucudan yasaklandınız.\n"
"[english]GameUI_ServerRejectBanned"	"You have been banned from this server.\n"
"GameUI_ServerRejectFailedChannel"	"İnternet kanalı oluşturma başarısız.\n"
"[english]GameUI_ServerRejectFailedChannel"	"Failed to create net channel.\n"
"GameUI_ServerRejectOldVersion"	"Bağlanmaya çalıştığınız sunucu oyunun daha eski\nbir sürümünü çalıştırıyor.\n"
"[english]GameUI_ServerRejectOldVersion"	"The server you are trying to connect to is running\nan older version of the game.\n"
"GameUI_ServerRejectBadSteamKey"	"Geçersiz Steam anahtar uzunluğu\n"
"[english]GameUI_ServerRejectBadSteamKey"	"Invalid Steam key length\n"
"GameUI_ServerRejectOldProtocol"	"Bu sunucu istemcinizden daha eski bir protokol kullanmaktadır.\n"
"[english]GameUI_ServerRejectOldProtocol"	"This server is using an older protocol than your client.\n"
"GameUI_ServerRejectNewProtocol"	"Bu sunucu istemcinizden daha yeni bir protokol kullanmaktadır.\n"
"[english]GameUI_ServerRejectNewProtocol"	"This server is using a newer protocol than your client.\n"
"GameUI_ServerRejectInvalidConnection"	"Geçersiz bağlantı.\n"
"[english]GameUI_ServerRejectInvalidConnection"	"Invalid connection.\n"
"GameUI_ServerRejectInvalidCertLen"	"Gerçersiz sertifika uzunluğu doğrulaması.\n"
"[english]GameUI_ServerRejectInvalidCertLen"	"Invalid authentication certificate length.\n"
"GameUI_ServerRejectInvalidSteamCertLen"	"STEAM sertifika uzunluğu hatası!\n"
"[english]GameUI_ServerRejectInvalidSteamCertLen"	"STEAM certificate length error!\n"
"GameUI_ServerRejectSteam"	"STEAM doğrulaması reddedildi\n"
"[english]GameUI_ServerRejectSteam"	"STEAM validation rejected\n"
"GameUI_ServerRejectGS"	"GSCreateLocalUser başarısız\n"
"[english]GameUI_ServerRejectGS"	"GSCreateLocalUser failed\n"
"GameUI_ServerRequireSteams"	"Bu sunucuya girebilmek için Steam'i çalıştırmalısınız.\n"
"[english]GameUI_ServerRequireSteams"	"The server requires that you be running Steam.\n"
"GameUI_ServerAuthDisabled"	"Kimlik doğrulama devre dışı bırakıldı.\n"
"[english]GameUI_ServerAuthDisabled"	"Authentication disabled.\n"
"GameUI_ServerCDKeyAuthInvalid"	"CD Anahtarı doğrulaması internet sunucuları için geçersiz.\n"
"[english]GameUI_ServerCDKeyAuthInvalid"	"CD Key authentication invalid for internet servers.\n"
"GameUI_ServerInvalidCDKey"	"Geçersiz CD Anahtarı.\n"
"[english]GameUI_ServerInvalidCDKey"	"Invalid CD Key.\n"
"GameUI_ServerCDKeyInUse"	"CD Anahtarı zaten kullanımda.\n"
"[english]GameUI_ServerCDKeyInUse"	"CD Key already in use.\n"
"GameUI_CrosshairNone"	"Yok"
"[english]GameUI_CrosshairNone"	"None"
"GameUI_ServerRejectNewVersion"	"Bağlanmaya çalıştığınız sunucu\noyunun yeni bir sürümünü çalıştırıyor.\n"
"[english]GameUI_ServerRejectNewVersion"	"The server you are trying to connect to is running\na newer version of the game.\n"
"GameUI_SteamVoice"	"Varsayılan ayar olarak sesli iletişim kullanılmaktadır fakat bazı sunucular aşağıda yer alan eski ayarları da kullanabilir."
"[english]GameUI_SteamVoice"	"Steam Voice is used by default, but some servers may use the old settings below."
"GameUI_SteamVoiceSettings"	"Sesli İletişim Ayarları"
"[english]GameUI_SteamVoiceSettings"	"Steam Voice Settings"
"GameUI_GameMenu_ReplayDemos"	"TEKRARLAR"
"[english]GameUI_GameMenu_ReplayDemos"	"REPLAYS"
"GameUI_GameMenu_ResumeReplay"	"TEKRARA DEVAM ET"
"[english]GameUI_GameMenu_ResumeReplay"	"RESUME REPLAY"
"GameUI_GameMenu_ExitReplay"	"TEKRARLARA DÖN"
"[english]GameUI_GameMenu_ExitReplay"	"BACK TO REPLAYS"
"GameUI_vote_yes_binding"	"Evet: %s1"
"[english]GameUI_vote_yes_binding"	"Yes: %s1"
"GameUI_vote_no_binding"	"Hayır: %s1"
"[english]GameUI_vote_no_binding"	"No: %s1"
"GameUI_vote_yes_tally"	"Evet"
"[english]GameUI_vote_yes_tally"	"Yes"
"GameUI_vote_no_tally"	"Hayır"
"[english]GameUI_vote_no_tally"	"No"
"GameUI_vote_header"	"%s1 oylama başlatmak istiyor:"
"[english]GameUI_vote_header"	"%s1 wants to call a vote:"
"Vote_notification_title"	"Oylama Başlatıldı"
"[english]Vote_notification_title"	"Vote Called"
"Vote_notification_text"	"%initiator% oylama başlatmak istiyor"
"[english]Vote_notification_text"	"%initiator% wants to call a vote"
"Vote_notification_view"	"Görüntüle"
"[english]Vote_notification_view"	"View"
"GameUI_vote_yes_instruction_a"	"Evet oyu için"
"[english]GameUI_vote_yes_instruction_a"	"Press START"
"GameUI_vote_no_instruction_a"	"Hayır oyu için"
"[english]GameUI_vote_no_instruction_a"	"Press BACK"
"GameUI_vote_yes_instruction_b"	"START tuşuna basın"
"[english]GameUI_vote_yes_instruction_b"	"to vote YES"
"GameUI_vote_no_instruction_b"	"BACK tuşuna basın"
"[english]GameUI_vote_no_instruction_b"	"to vote NO"
"GameUI_vote_yes_pc_instruction"	"EVET oyu için F1 tuşuna basın"
"[english]GameUI_vote_yes_pc_instruction"	"Press F1 to vote YES"
"GameUI_vote_no_pc_instruction"	"HAYIR oyu için F2 tuşuna basın"
"[english]GameUI_vote_no_pc_instruction"	"Press F2 to vote NO"
"GameUI_vote_current_vote_count"	"Oy sayısı:"
"[english]GameUI_vote_current_vote_count"	"Vote count:"
"GameUI_vote_passed"	"Oylama Başarılı!"
"[english]GameUI_vote_passed"	"Vote Passed!"
"GameUI_vote_failed"	"Oylama Başarısız."
"[english]GameUI_vote_failed"	"Vote Failed."
"GameUI_vote_failed_quorum"	"Yeterli sayıda oy alınamadı."
"[english]GameUI_vote_failed_quorum"	"Not enough players voted."
"GameUI_vote_failed_yesno"	"Evet oyları Hayır oylarından fazla olmalı."
"[english]GameUI_vote_failed_yesno"	"Yes votes must exceed No votes."
"GameUI_vote_failed_vote_spam"	"Yakın zamanda oylama isteğinde bulunduğundan %s1 saniye yeni bir oylama başlatamazsın."
"[english]GameUI_vote_failed_vote_spam"	"You called a vote recently and can not call another for %s1 seconds."
"GameUI_vote_failed_transition_vote"	"Oyuncular yükleme ekranındayken oylama başlatamazsınız."
"[english]GameUI_vote_failed_transition_vote"	"You cannot call a new vote while other players are still loading."
"GameUI_vote_failed_disabled_issue"	"Sunucu bu özelliği devre dışı bırakmış."
"[english]GameUI_vote_failed_disabled_issue"	"Server has disabled that issue."
"GameUI_vote_failed_map_not_found"	"Bu harita mevcut değil."
"[english]GameUI_vote_failed_map_not_found"	"That map does not exist."
"GameUI_vote_failed_map_name_required"	"Bir harita adı belirtmelisiniz."
"[english]GameUI_vote_failed_map_name_required"	"You must specify a map name."
"GameUI_vote_failed_recently"	"Oylama başarısız oldu ve %s1 saniyeden önce tekrar oylama yapılamaz."
"[english]GameUI_vote_failed_recently"	"This vote failed recently and can not be called again for %s1 seconds."
"GameUI_vote_failed_team_cant_call"	"Takımınız bu oylamayı başlatamaz."
"[english]GameUI_vote_failed_team_cant_call"	"Your team cannot call this vote."
"GameUI_vote_failed_waitingforplayers"	"Oyuncular Bekleniyor sırasında oylama yapılamaz."
"[english]GameUI_vote_failed_waitingforplayers"	"Voting not allowed while Waiting For Players."
"GameUI_vote_failed_cannot_kick_admin"	"Sunucu yöneticisini atmak için oylama başlatamazsınız."
"[english]GameUI_vote_failed_cannot_kick_admin"	"You may not vote to kick the server admin."
"GameUI_vote_failed_scramble_in_prog"	"Takım Karıştırma işlemi yapılıyor."
"[english]GameUI_vote_failed_scramble_in_prog"	"A Team Scramble is in progress."
"GameUI_vote_failed_spectator"	"Bu sunucu Seyircilerin oy verme yetkisini devre dışı bırakmış."
"[english]GameUI_vote_failed_spectator"	"This server has disabled voting for Spectators."
"GameUI_vote_extend_current_map"	"Şu anki haritada devam et."
"[english]GameUI_vote_extend_current_map"	"Extend current Map."
"GameUI_vote_yes"	"Bu oylamaya evet oyu ver"
"[english]GameUI_vote_yes"	"Vote yes on active issue"
"GameUI_vote_no"	"Bu oylamaya hayır oyu ver"
"[english]GameUI_vote_no"	"Vote no on active issue"
"GameUI_call_vote"	"Oylama başlat"
"[english]GameUI_call_vote"	"Call vote"
"GameUI_CancelBold"	"İPTAL"
"[english]GameUI_CancelBold"	"CANCEL"
"GameUI_Language_Romanian"	"Rumence"
"[english]GameUI_Language_Romanian"	"Romanian"
"GameUI_Language_Turkish"	"Türkçe"
"[english]GameUI_Language_Turkish"	"Turkish"
"GameUI_Language_Hungarian"	"Macarca"
"[english]GameUI_Language_Hungarian"	"Hungarian"
"GameUI_Confirm"	"ONAYLA"
"[english]GameUI_Confirm"	"CONFIRM"
"GameUI_D3D9Ex"	"Windows Aero eklentileri:"
"[english]GameUI_D3D9Ex"	"Windows Aero extensions:"
"GameUI_D3D9ExRelaunchMsg"	"Bu ayar, oyunu kapatıp tekrar başlatana kadar değiştirilmeyecektir."
"[english]GameUI_D3D9ExRelaunchMsg"	"This setting will not take effect until you exit and re-launch the game."
"GameUI_vote_failed_map_not_valid"	"Bu harita sunucunun harita döngüsünde bulunmuyor."
"[english]GameUI_vote_failed_map_not_valid"	"That map was not found in the server's map cycle."
"GameUI_ServerRejectMustUseMatchmaking"	"Bu sunucu sadece eşleştirme yoluyla gönderilen bağlantıları kabul etmektedir. Sunucu bağlantıları kullanılamaz\n"
"[english]GameUI_ServerRejectMustUseMatchmaking"	"This server only accepts connections negotiated through matchmaking.  Ad-hoc connections are not allowed\n"
"GameUI_vote_failed_cannot_kick_for_time"	"Bu oyuncu %s1 saniye daha atılamaz."
"[english]GameUI_vote_failed_cannot_kick_for_time"	"This player cannot be kicked for %s1 more seconds."
"GameUI_vote_failed_round_active"	"Oyuncular raunt sırasında oyundan atılamazlar."
"[english]GameUI_vote_failed_round_active"	"Players cannot be kicked while round is active."
"GameUI_ServerRequireSteam"	"Sunucuya girebilmek için Steam çalışıyor olmalıdır.\n"
"[english]GameUI_ServerRequireSteam"	"The server requires that you be running Steam.\n"
"GameUI_All_ImagesNoBmp"	"Tüm Resimler (*.jpg,*.tga,*.vtf)"
"[english]GameUI_All_ImagesNoBmp"	"All Images (*.jpg,*.tga,*.vtf)"
"GameUI_DownloadFilter_MapsOnly"	"Sadece harita dosyalarına izin ver"
"[english]GameUI_DownloadFilter_MapsOnly"	"Only allow map files"
"GameUI_GameMenu_ActivateVR"	"SANAL GERÇEKLİĞİ ETKİNLEŞTİR"
"[english]GameUI_GameMenu_ActivateVR"	"ACTIVATE VIRTUAL REALITY"
"GameUI_GameMenu_DeactivateVR"	"SANAL GERÇEKLİĞİ KAPAT"
"[english]GameUI_GameMenu_DeactivateVR"	"DEACTIVATE VIRTUAL REALITY"
"GameUI_VRMode"	"Sanal Gerçeklik Modu"
"[english]GameUI_VRMode"	"Virtual Reality Mode"
"GameUI_VRModeRelaunchMsg"	"Sanal Gerçeklik Modunu etkinleştirmek veya kapatmak için oyunun yeniden başlatılması gerekir."
"[english]GameUI_VRModeRelaunchMsg"	"Enabling or disabling Virtual Reality Mode will not take effect until you restart the game."
"GameUI_WindowedTooltip"	"SG modu etkin iken oyun, ana ekranda pencere hâlinde çalışacak. SG moduna geçmek için Sanal Gerçekliği Etkinleştir'i seçin."
"[english]GameUI_WindowedTooltip"	"When VR mode is enabled the game will start windowed on the main display. Select Activate Virtual Reality to switch to VR."
"GameUI_NoVRTooltip"	"Ekran algılanmadı. Uyumlu SG ekranınızı bağlayın ve SG modunu etkinleştirmek için oyunu yeniden başlatın."
"[english]GameUI_NoVRTooltip"	"No display detected. Connect your compatible VR display and restart the game to enable VR mode."
"GameUI_HDContent"	"Mevcut ise HD içeriği yükle"
"[english]GameUI_HDContent"	"Load HD content if available"
"GameUI_HDRestartRequired_Info"	"Yaptığınız değişikliklerin uygulanabilmesi için oyunun yeniden başlatılması gerekiyor."
"[english]GameUI_HDRestartRequired_Info"	"The changes you have made require the game to be restarted to take effect."
"GameUI_PortalDepth4"	"4"
"[english]GameUI_PortalDepth4"	"4"
"GameUI_Icons_BACK"	"4"
"[english]GameUI_Icons_BACK"	"4"
"GameUI_vote_failed_nextlevel_set"	"Sonraki bölüm zaten ayarlandı."
"[english]GameUI_vote_failed_nextlevel_set"	"The next level has already been set."
"GameUI_Language_Czech"	"Çekce"
"[english]GameUI_Language_Czech"	"Czech"
"GameUI_Language_Brazilian"	"Brezilya Portekizcesi"
"[english]GameUI_Language_Brazilian"	"Portuguese-Brazil"
"GameUI_Language_Bulgarian"	"Bulgarca"
"[english]GameUI_Language_Bulgarian"	"Bulgarian"
"GameUI_Language_Greek"	"Yunanca"
"[english]GameUI_Language_Greek"	"Greek"
"GameUI_Language_Ukrainian"	"Ukraynaca"
"[english]GameUI_Language_Ukrainian"	"Ukrainian"
}
}
